"","philanthropist","socializer","freeSpirit","achiever","player","disruptor","A2","A4","D3","D4","F1","F3","P1","P4","R2","R4","S2","S4","Completion Time","Age","Gender","Country","Education","Freq Games"
"4",14,14,13,14,7,7,7,7,6,1,6,7,7,7,5,2,7,7,85.867999792099,75,NA,"","",1
"5",14,14,14,14,14,2,7,7,1,1,7,7,7,7,7,7,7,7,75.566999912262,NA,NA,"","",NA
"6",13,10,11,9,13,10,3,6,4,6,5,6,7,6,7,6,6,4,42.2809998989105,NA,NA,"","",NA
"7",13,2,14,9,2,5,5,4,4,1,7,7,7,6,1,1,1,1,66.0279998779297,69,"female","Argentina","Formación comercial/técnica/vocacional",7
"9",13,6,13,13,6,7,6,7,6,1,6,7,7,6,1,5,1,5,91.7479999065399,72,"female","Venezuela (República Bolivariana de)","Grado profesional",7
"12",14,14,14,14,14,10,7,7,5,5,7,7,7,7,7,7,7,7,41.4509997367859,65,"female","Argentina","",NA
"14",14,14,14,13,14,2,6,7,1,1,7,7,7,7,7,7,7,7,64.9279999732971,NA,NA,"","",NA
"17",14,8,14,14,13,11,7,7,7,4,7,7,7,7,6,7,1,7,47.8709998130798,66,"female","","",NA
"19",14,4,14,8,13,3,2,6,1,2,7,7,7,7,7,6,2,2,98.2119998931885,40,"female","Venezuela (República Bolivariana de)","Formación comercial/técnica/vocacional",1
"24",14,14,13,13,13,2,6,7,1,1,7,6,7,7,7,6,7,7,102.882000207901,80,"female","Argentina","Maestría",4
"25",12,12,14,13,14,14,6,7,7,7,7,7,6,6,7,7,6,6,43.3389999866486,59,"male","Argentina","Formación comercial/técnica/vocacional",5
"27",12,14,14,14,14,11,7,7,7,4,7,7,6,6,7,7,7,7,49.8270001411438,67,NA,"Argentina","Formación comercial/técnica/vocacional",1
"28",13,9,14,14,14,9,7,7,6,3,7,7,6,7,7,7,6,3,83.047000169754,65,"male","Nicaragua","Maestría",NA
"30",14,14,14,14,14,13,7,7,6,7,7,7,7,7,7,7,7,7,119.16100025177,NA,NA,"","",NA
"35",8,5,13,7,7,7,3,4,3,4,7,6,4,4,3,4,3,2,53.4289999008179,52,NA,"","Licenciatura",NA
"36",14,14,14,14,13,6,7,7,5,1,7,7,7,7,6,7,7,7,56.6050000190735,42,NA,"Venezuela (República Bolivariana de)","Licenciatura",1
"42",14,14,14,14,14,2,7,7,1,1,7,7,7,7,7,7,7,7,90.6029996871948,NA,NA,"","",NA
"43",14,14,14,12,11,2,5,7,1,1,7,7,7,7,5,6,7,7,70.3230001926422,56,"female","Venezuela (República Bolivariana de)","Bachillerato",NA
"45",14,14,11,14,2,5,7,7,4,1,4,7,7,7,1,1,7,7,72.8559999465942,NA,NA,"","",NA
"46",14,3,12,12,14,11,5,7,5,6,5,7,7,7,7,7,1,2,60.646999835968,51,NA,"Colombia","Bachillerato",1
"47",14,14,14,13,8,3,6,7,1,2,7,7,7,7,6,2,7,7,74.5260000228882,31,"female","Guatemala","Bachillerato",NA
"51",14,14,14,11,4,8,5,6,6,2,7,7,7,7,3,1,7,7,81.5539999008179,57,"female","Venezuela (República Bolivariana de)","Bachillerato",1
"52",14,11,14,14,12,8,7,7,3,5,7,7,7,7,6,6,4,7,50.3420000076294,NA,NA,"","",NA
"55",12,12,11,13,14,4,6,7,3,1,6,5,7,5,7,7,7,5,107.620000123978,63,"female","Venezuela (República Bolivariana de)","Maestría",7
"56",14,11,14,11,14,8,4,7,5,3,7,7,7,7,7,7,6,5,63.5250000953674,63,"female","Uruguay","Formación comercial/técnica/vocacional",7
"58",14,11,14,13,10,8,6,7,4,4,7,7,7,7,5,5,5,6,60.5579998493195,74,"female","Argentina","Bachillerato",7
"59",2,7,4,3,4,7,2,1,5,2,3,1,1,1,2,2,4,3,70.6769998073578,55,NA,"Venezuela (República Bolivariana de)","Formación comercial/técnica/vocacional",1
"60",14,12,11,12,10,6,6,6,4,2,7,4,7,7,5,5,6,6,75.3210000991821,59,"male","Venezuela (República Bolivariana de)","Bachillerato",3
"61",12,8,13,13,5,14,7,6,7,7,6,7,6,6,1,4,4,4,70.260999917984,NA,NA,"","",NA
"62",10,7,10,12,12,6,6,6,3,3,5,5,5,5,6,6,3,4,62.4079999923706,60,NA,"Argentina","Bachillerato",7
"63",14,8,14,14,4,13,7,7,7,6,7,7,7,7,2,2,5,3,96.4200000762939,58,"male","","Bachillerato",1
"65",14,7,13,14,13,2,7,7,1,1,7,6,7,7,7,6,2,5,89.7649998664856,66,NA,"Argentina","Bachillerato",NA
"66",14,9,12,13,13,2,6,7,1,1,6,6,7,7,6,7,2,7,88.7920000553131,43,"female","Colombia","Formación comercial/técnica/vocacional",1
"68",14,14,14,13,10,4,6,7,1,3,7,7,7,7,6,4,7,7,90.3429999351501,82,"male","Venezuela (República Bolivariana de)","Bachillerato",1
"69",14,14,14,14,14,13,7,7,7,6,7,7,7,7,7,7,7,7,55.3060002326965,30,"female","Venezuela (República Bolivariana de)","Bachillerato",5
"72",14,14,13,12,14,2,6,6,1,1,7,6,7,7,7,7,7,7,51.2560000419617,NA,NA,"","",NA
"74",14,14,14,13,5,8,6,7,6,2,7,7,7,7,4,1,7,7,103.592000007629,NA,NA,"","",NA
"75",9,11,12,10,13,12,5,5,6,6,6,6,4,5,7,6,4,7,68.2820000648499,60,NA,"Venezuela (República Bolivariana de)","Grado profesional",7
"79",7,7,12,13,14,11,7,6,6,5,6,6,3,4,7,7,4,3,59.393000125885,53,"female","Venezuela (República Bolivariana de)","Maestría",1
"80",14,14,14,14,2,14,7,7,7,7,7,7,7,7,1,1,7,7,77.2760000228882,66,"male","Colombia","Bachillerato",NA
"82",14,13,12,13,9,10,6,7,5,5,6,6,7,7,5,4,7,6,68.239000082016,73,NA,"Paraguay","Grado profesional",NA
"83",14,14,11,13,10,6,6,7,4,2,7,4,7,7,7,3,7,7,59.1440000534058,58,"female","Argentina","Bachillerato",1
"85",14,14,14,12,13,6,6,6,3,3,7,7,7,7,7,6,7,7,100.227999687195,70,"female","Venezuela (República Bolivariana de)","Formación comercial/técnica/vocacional",7
"87",14,11,14,14,14,5,7,7,1,4,7,7,7,7,7,7,6,5,68.0400002002716,62,"male","Venezuela (República Bolivariana de)","Licenciatura",1
"90",14,10,11,11,9,4,5,6,2,2,5,6,7,7,4,5,5,5,115.534999847412,70,"female","Argentina","Grado profesional",1
"91",12,6,14,14,14,11,7,7,4,7,7,7,6,6,7,7,3,3,104.257999897003,56,"male","Venezuela (República Bolivariana de)","Bachillerato",NA
"93",14,10,5,8,11,6,4,4,2,4,1,4,7,7,4,7,6,4,104.069000005722,29,NA,"Venezuela (República Bolivariana de)","Bachillerato",1
"94",13,14,8,12,14,5,5,7,1,4,1,7,7,6,7,7,7,7,43.6440000534058,19,"female","Venezuela (República Bolivariana de)","Bachillerato",1
"95",14,11,14,9,13,13,5,4,7,6,7,7,7,7,7,6,4,7,54.0019998550415,54,"female","Perú","Formación comercial/técnica/vocacional",2
"97",14,13,14,14,14,8,7,7,6,2,7,7,7,7,7,7,6,7,68.3049998283386,NA,NA,"","",NA
"98",14,14,13,13,14,12,6,7,6,6,7,6,7,7,7,7,7,7,63.3759999275208,56,"female","Colombia","Bachillerato",1
"99",7,7,13,13,10,12,7,6,7,5,7,6,4,3,5,5,3,4,102.878999710083,63,"male","Colombia","Bachillerato",1
"100",13,10,14,12,8,9,6,6,5,4,7,7,7,6,4,4,5,5,70.2130000591278,60,"female","Argentina","Maestría",NA
"105",14,11,12,10,11,10,4,6,4,6,6,6,7,7,4,7,6,5,77.4249999523163,65,"female","Venezuela (República Bolivariana de)","Formación comercial/técnica/vocacional",4
"107",14,14,14,14,12,2,7,7,1,1,7,7,7,7,5,7,7,7,52.6429998874664,68,NA,"Nicaragua","Licenciatura",5
"108",10,10,13,12,10,12,6,6,6,6,6,7,5,5,5,5,6,4,70.0519998073578,50,"male","","Bachillerato",2
"110",14,12,14,14,13,13,7,7,7,6,7,7,7,7,6,7,6,6,90.2869999408722,67,"female","Argentina","Bachillerato",4
"111",12,8,12,13,8,9,6,7,4,5,6,6,6,6,5,3,4,4,132.018000125885,NA,NA,"","",NA
"112",14,14,14,14,14,8,7,7,3,5,7,7,7,7,7,7,7,7,54.0449998378754,34,NA,"Colombia","Formación comercial/técnica/vocacional",1
"113",10,11,11,12,7,9,6,6,6,3,6,5,6,4,1,6,5,6,62.5910000801086,64,"male","Argentina","Maestría",1
"120",13,10,12,13,13,11,6,7,5,6,5,7,7,6,6,7,5,5,102.96799993515,NA,NA,"","",NA
"121",10,13,13,11,11,9,5,6,5,4,6,7,6,4,6,5,7,6,44.8199999332428,69,"female","Argentina","Bachillerato",7
"122",14,14,14,14,14,2,7,7,1,1,7,7,7,7,7,7,7,7,84.0340001583099,61,"male","Venezuela (República Bolivariana de)","",NA
"123",14,14,14,14,14,6,7,7,3,3,7,7,7,7,7,7,7,7,64.3489999771118,NA,NA,"","",NA
"127",13,12,14,14,14,12,7,7,7,5,7,7,7,6,7,7,5,7,62.271999835968,NA,NA,"","",NA
"129",14,14,14,13,8,2,7,6,1,1,7,7,7,7,5,3,7,7,54.6080002784729,NA,NA,"","",NA
"130",14,13,14,13,10,11,7,6,6,5,7,7,7,7,4,6,6,7,61.2279999256134,NA,"female","Argentina","Grado profesional",1
"131",13,7,8,9,5,8,4,5,4,4,4,4,7,6,1,4,4,3,66.585000038147,39,"female","Venezuela (República Bolivariana de)","Bachillerato",1
"133",14,11,14,13,14,14,6,7,7,7,7,7,7,7,7,7,6,5,78.5170001983643,63,"female","Argentina","Bachillerato",NA
"134",10,12,14,11,10,9,5,6,3,6,7,7,5,5,5,5,6,6,80.0820002555847,57,"male","Venezuela (República Bolivariana de)","Bachillerato",1
"136",14,14,13,14,10,4,7,7,3,1,7,6,7,7,7,3,7,7,63.9989998340607,58,"female","Argentina","Grado profesional",NA
"138",14,9,14,13,9,3,6,7,1,2,7,7,7,7,2,7,7,2,68.2879998683929,58,"male","Venezuela (República Bolivariana de)","Formación comercial/técnica/vocacional",1
"139",14,14,14,14,14,2,7,7,1,1,7,7,7,7,7,7,7,7,77.2060000896454,48,"female","Perú","",NA
"140",14,14,14,12,13,6,6,6,1,5,7,7,7,7,6,7,7,7,81.2199997901917,81,"female","Argentina","Bachillerato",7
"145",14,10,14,14,10,14,7,7,7,7,7,7,7,7,5,5,5,5,53.268000125885,60,"female","El Salvador","Licenciatura",NA
"146",14,14,7,14,13,14,7,7,7,7,6,1,7,7,6,7,7,7,83.9249999523163,NA,"male","","",NA
"149",12,10,13,10,10,11,5,5,4,7,6,7,6,6,5,5,5,5,68.4260001182556,67,NA,"Argentina","Formación comercial/técnica/vocacional",1
"150",7,7,14,10,12,5,3,7,3,2,7,7,6,1,7,5,1,6,67.433000087738,80,"female","Argentina","Grado profesional",2
"153",14,10,14,14,14,8,7,7,4,4,7,7,7,7,7,7,5,5,44.960000038147,NA,NA,"","",NA
"154",14,12,14,14,14,2,7,7,1,1,7,7,7,7,7,7,7,5,69.9939999580383,53,"male","Colombia","Bachillerato",NA
"156",12,12,12,11,12,11,5,6,5,6,6,6,6,6,6,6,6,6,56.0520000457764,77,NA,"Argentina","Formación comercial/técnica/vocacional",6
"157",14,7,13,14,14,2,7,7,1,1,6,7,7,7,7,7,1,6,135.076999664307,67,"female","Argentina","",2
"158",14,12,11,12,12,6,6,6,5,1,6,5,7,7,5,7,7,5,47.1800000667572,56,"female","Argentina","Licenciatura",NA
"163",12,12,11,13,12,11,6,7,4,7,5,6,6,6,6,6,5,7,67.5590000152588,58,"female","Colombia","Bachillerato",1
"164",14,14,13,12,11,3,6,6,2,1,6,7,7,7,5,6,7,7,86.2569999694824,67,"male","Venezuela (República Bolivariana de)","Bachillerato",1
"165",14,14,2,14,14,2,7,7,1,1,1,1,7,7,7,7,7,7,93.5149998664856,NA,NA,"","",NA
"167",13,10,14,13,10,7,6,7,1,6,7,7,6,7,5,5,5,5,75.2250001430511,62,"female","","Formación comercial/técnica/vocacional",NA
"168",14,8,14,14,14,2,7,7,1,1,7,7,7,7,7,7,7,1,64.1700000762939,NA,NA,"","",NA
"169",9,6,14,13,9,10,7,6,7,3,7,7,4,5,5,4,4,2,94.3050000667572,63,"male","Colombia","Bachillerato",1
"171",13,14,12,14,11,6,7,7,1,5,6,6,7,6,4,7,7,7,39.8270001411438,50,"female","Bolivia (Estado Plurinacional de)","Doctorado",1
"172",14,11,14,13,10,2,7,6,1,1,7,7,7,7,6,4,4,7,124.619000196457,NA,NA,"","",NA
"174",8,12,14,14,14,12,7,7,7,5,7,7,7,1,7,7,6,6,86.3669998645782,67,"female","Argentina","Bachillerato",1
"182",13,11,14,13,11,9,6,7,3,6,7,7,6,7,5,6,5,6,65.3469998836517,47,"female","Perú","Formación comercial/técnica/vocacional",1
"183",13,14,14,14,14,14,7,7,7,7,7,7,7,6,7,7,7,7,30.4150002002716,43,"female","Venezuela (República Bolivariana de)","Bachillerato",1
"184",11,14,14,13,14,10,6,7,7,3,7,7,6,5,7,7,7,7,93.1579999923706,NA,NA,"","",NA
"186",13,14,12,12,14,11,5,7,5,6,6,6,7,6,7,7,7,7,75.1400001049042,62,"female","Paraguay","Licenciatura",5
"188",13,8,14,14,12,10,7,7,3,7,7,7,7,6,5,7,5,3,59.9130001068115,53,NA,"Argentina","Grado profesional",1
"189",14,12,14,12,12,2,6,6,1,1,7,7,7,7,6,6,6,6,71.9619998931885,70,"female","Argentina","Grado profesional",1
"193",14,9,14,14,14,8,7,7,6,2,7,7,7,7,7,7,7,2,86.5209999084473,49,"female","Colombia","Bachillerato",1
"194",11,2,14,14,11,14,7,7,7,7,7,7,6,5,4,7,1,1,56.6710000038147,NA,NA,"","",NA
"196",14,12,12,13,12,3,6,7,2,1,6,6,7,7,6,6,6,6,64.5629999637604,57,"male","Colombia","Licenciatura",1
"199",7,7,11,13,13,6,6,7,4,2,5,6,4,3,7,6,4,3,60.4569997787476,49,NA,"Argentina","Licenciatura",7
"202",14,14,14,14,14,2,7,7,1,1,7,7,7,7,7,7,7,7,95.393000125885,36,NA,"Venezuela (República Bolivariana de)","Grado profesional",1
"203",14,14,14,14,2,2,7,7,1,1,7,7,7,7,1,1,7,7,65.8929998874664,66,"female","","",3
"204",11,10,12,13,12,3,7,6,1,2,7,5,7,4,6,6,4,6,67.6269998550415,19,"male","Venezuela (República Bolivariana de)","Bachillerato",3
"205",11,13,2,10,8,2,5,5,1,1,1,1,7,4,4,4,7,6,59.5759999752045,46,"male","Argentina","Maestría",1
"206",11,12,14,13,12,12,7,6,5,7,7,7,7,4,7,5,6,6,84.3589999675751,NA,"female","","",7
"207",13,12,14,12,14,7,5,7,4,3,7,7,6,7,7,7,5,7,62.8799998760223,NA,NA,"","",NA
"211",14,12,14,12,13,7,5,7,1,6,7,7,7,7,6,7,6,6,73.3060002326965,50,"female","Colombia","Grado profesional",1
"212",14,13,14,13,12,7,6,7,1,6,7,7,7,7,7,5,7,6,107.391999959946,56,"female","Argentina","Bachillerato",1
"213",14,11,14,13,12,2,6,7,1,1,7,7,7,7,5,7,5,6,66.5299999713898,59,"female","Argentina","",1
"214",14,14,14,14,14,7,7,7,2,5,7,7,7,7,7,7,7,7,67.53600025177,45,"male","Venezuela (República Bolivariana de)","Formación comercial/técnica/vocacional",2
"217",14,14,14,14,14,10,7,7,3,7,7,7,7,7,7,7,7,7,38.3059997558594,NA,NA,"","",NA
"219",14,14,14,14,14,2,7,7,1,1,7,7,7,7,7,7,7,7,65.2039999961853,NA,NA,"","",NA
"220",11,9,14,11,13,7,5,6,6,1,7,7,5,6,6,7,6,3,79.4769997596741,69,"male","Argentina","Formación comercial/técnica/vocacional",NA
"223",14,8,14,14,14,13,7,7,7,6,7,7,7,7,7,7,4,4,50.2170000076294,NA,NA,"","",NA
"225",12,12,13,14,14,12,7,7,6,6,7,6,6,6,7,7,6,6,61.1640000343323,64,NA,"Colombia","Formación comercial/técnica/vocacional",7
"226",14,8,10,13,13,8,6,7,6,2,4,6,7,7,7,6,5,3,51.3869998455048,56,NA,"Argentina","Grado profesional",1
"227",6,11,13,14,6,6,7,7,5,1,6,7,3,3,4,2,5,6,70.4559998512268,71,NA,"Argentina","Licenciatura",6
"228",8,2,14,14,11,14,7,7,7,7,7,7,1,7,7,4,1,1,56.7180001735687,52,NA,"Venezuela (República Bolivariana de)","Bachillerato",4
"230",12,10,12,8,12,7,3,5,4,3,6,6,6,6,6,6,5,5,111.542999982834,NA,NA,"","",NA
"231",14,14,14,12,12,3,6,6,2,1,7,7,7,7,6,6,7,7,82.2130000591278,80,"female","Costa Rica","Licenciatura",3
"233",14,12,14,12,14,10,6,6,4,6,7,7,7,7,7,7,6,6,46.9520001411438,56,"female","Perú","Grado profesional",1
"235",14,9,14,14,4,8,7,7,3,5,7,7,7,7,2,2,4,5,53.9159998893738,45,"female","Chile","Formación comercial/técnica/vocacional",NA
"236",10,6,11,14,9,8,7,7,4,4,4,7,6,4,5,4,2,4,71.3900001049042,32,"female","Colombia","Bachillerato",4
"238",14,13,13,13,13,14,6,7,7,7,7,6,7,7,6,7,7,6,49.0820000171661,NA,NA,"","",NA
"240",14,14,10,14,4,10,7,7,7,3,7,3,7,7,3,1,7,7,70.6710000038147,58,"female","Argentina","",1
"242",14,14,14,12,11,2,6,6,1,1,7,7,7,7,5,6,7,7,85.4430000782013,80,"female","Argentina","Maestría",6
"243",14,13,9,14,14,9,7,7,5,4,5,4,7,7,7,7,7,6,63.4559998512268,72,"male","Argentina","Maestría",1
"244",14,14,14,14,14,4,7,7,3,1,7,7,7,7,7,7,7,7,58.4800000190735,65,"female","Argentina","Grado profesional",NA
"246",13,11,14,14,9,8,7,7,2,6,7,7,7,6,3,6,5,6,84.1589999198914,28,NA,"El Salvador","Bachillerato",1
"249",14,11,14,14,14,11,7,7,6,5,7,7,7,7,7,7,7,4,137.916000127792,71,"female","Argentina","Bachillerato",3
"250",12,13,14,14,14,13,7,7,7,6,7,7,6,6,7,7,7,6,76.6399998664856,85,"female","","Grado profesional",1
"251",14,11,14,14,14,14,7,7,7,7,7,7,7,7,7,7,7,4,80.2350001335144,58,"female","Argentina","Formación comercial/técnica/vocacional",3
"252",14,6,14,12,10,2,5,7,1,1,7,7,7,7,6,4,3,3,77.5960001945496,66,"female","Argentina","Bachillerato",7
"255",14,5,14,14,14,14,7,7,7,7,7,7,7,7,7,7,4,1,33.6119999885559,29,NA,"Venezuela (República Bolivariana de)","Bachillerato",1
"256",14,12,14,14,12,11,7,7,6,5,7,7,7,7,5,7,5,7,63.1210000514984,71,NA,"Argentina","",NA
"258",14,14,13,13,13,14,6,7,7,7,7,6,7,7,6,7,7,7,68.7049999237061,65,"female","","",NA
"262",14,14,12,14,12,3,7,7,2,1,6,6,7,7,6,6,7,7,81.470999956131,67,"male","","Bachillerato",NA
"263",14,14,14,13,14,2,6,7,1,1,7,7,7,7,7,7,7,7,59.25,57,NA,"Colombia","Bachillerato",1
"267",14,8,11,11,11,11,7,4,5,6,4,7,7,7,7,4,4,4,63.6790001392365,63,"female","Argentina","Bachillerato",5
"268",14,14,14,14,13,14,7,7,7,7,7,7,7,7,6,7,7,7,46.378999710083,85,NA,"","Grado profesional",NA
"269",10,6,14,12,5,8,6,6,6,2,7,7,4,6,1,4,3,3,90.6510000228882,77,"female","Argentina","Bachillerato",5
"272",14,14,14,12,11,2,6,6,1,1,7,7,7,7,6,5,7,7,82.5100002288818,80,"female","Argentina","Formación comercial/técnica/vocacional",NA
"273",14,14,14,14,13,12,7,7,6,6,7,7,7,7,6,7,7,7,57.316999912262,56,NA,"","Bachillerato",1
"274",6,8,14,14,10,11,7,7,6,5,7,7,4,2,5,5,5,3,107.086000204086,51,"male","Argentina","Bachillerato",1
"275",14,12,13,11,4,9,5,6,7,2,6,7,7,7,2,2,6,6,84.6600000858307,54,NA,"Venezuela (República Bolivariana de)","Bachillerato",NA
"276",13,5,14,14,8,13,7,7,6,7,7,7,7,6,6,2,3,2,69.4840002059937,NA,NA,"","",NA
"282",14,8,14,14,14,2,7,7,1,1,7,7,7,7,7,7,1,7,58.5789999961853,66,NA,"Argentina","Licenciatura",1
"286",12,11,12,12,13,11,6,6,6,5,6,6,6,6,7,6,6,5,51.4079999923706,60,NA,"Argentina","Bachillerato",4
"289",11,11,11,14,8,5,7,7,3,2,4,7,5,6,4,4,6,5,79.7690000534058,NA,NA,"","",NA
"292",12,10,12,13,14,8,6,7,4,4,7,5,6,6,7,7,5,5,81.6840000152588,19,"male","Venezuela (República Bolivariana de)","Bachillerato",7
"296",14,12,10,13,13,7,6,7,1,6,6,4,7,7,7,6,6,6,114.361999988556,NA,NA,"","",NA
"297",12,11,14,14,14,13,7,7,7,6,7,7,7,5,7,7,5,6,57.7449998855591,22,"male","Venezuela (República Bolivariana de)","Bachillerato",1
"298",11,8,7,14,14,12,7,7,5,7,6,1,6,5,7,7,4,4,62.3939998149872,NA,NA,"","",NA
"299",13,14,13,12,7,8,6,6,6,2,6,7,6,7,6,1,7,7,64.3769998550415,NA,NA,"","",NA
"301",14,14,14,14,14,2,7,7,1,1,7,7,7,7,7,7,7,7,65.1549999713898,83,NA,"Venezuela (República Bolivariana de)","Licenciatura",NA
"303",14,9,14,14,12,14,7,7,7,7,7,7,7,7,5,7,3,6,52.3039999008179,56,NA,"Argentina","Formación comercial/técnica/vocacional",1
"305",14,14,13,13,13,7,7,6,5,2,7,6,7,7,7,6,7,7,86.6890001296997,49,"male","Venezuela (República Bolivariana de)","Licenciatura",2
"306",14,14,14,14,14,2,7,7,1,1,7,7,7,7,7,7,7,7,45.1979999542236,63,"female","Argentina","Grado de asociado",1
"309",13,12,13,13,12,10,7,6,5,5,6,7,7,6,5,7,6,6,77.4470000267029,43,NA,"Argentina","Bachillerato",1
"312",14,14,14,14,14,2,7,7,1,1,7,7,7,7,7,7,7,7,94.8039999008179,60,"female","Colombia","Licenciatura",5
"313",12,4,13,13,8,11,6,7,5,6,6,7,6,6,6,2,2,2,125.269999980927,NA,NA,"","",5
"314",8,2,11,10,12,9,3,7,3,6,6,5,4,4,5,7,1,1,58.3810000419617,37,NA,"Chile","Formación comercial/técnica/vocacional",NA
"317",7,7,12,14,13,8,7,7,4,4,6,6,4,3,7,6,4,3,83.951000213623,NA,NA,"","",NA
"319",14,14,14,14,14,2,7,7,1,1,7,7,7,7,7,7,7,7,82.3490002155304,NA,"male","Colombia","Grado profesional",NA
"320",14,13,14,14,13,14,7,7,7,7,7,7,7,7,6,7,6,7,63.7979998588562,70,"female","Argentina","Licenciatura",NA
"324",14,14,14,14,10,14,7,7,7,7,7,7,7,7,5,5,7,7,60.3250002861023,65,"male","Argentina","Bachillerato",1
"325",14,12,11,14,11,9,7,7,3,6,6,5,7,7,4,7,6,6,45.0469999313354,46,"male","Venezuela (República Bolivariana de)","Bachillerato",7
"327",14,14,14,11,13,7,6,5,6,1,7,7,7,7,7,6,7,7,52.2819998264313,37,"female","","Bachillerato",1
"329",13,8,14,14,7,13,7,7,7,6,7,7,7,6,4,3,3,5,63.8159999847412,NA,NA,"","",NA
"331",13,10,14,11,10,12,5,6,6,6,7,7,7,6,5,5,5,5,64.1780002117157,NA,"female","Chile","",1
"332",14,8,14,11,9,11,4,7,7,4,7,7,7,7,5,4,4,4,73.7929997444153,NA,NA,"","",NA
"333",14,14,14,13,8,11,7,6,7,4,7,7,7,7,4,4,7,7,49.4939999580383,54,"female","Uruguay","Licenciatura",NA
"336",14,14,14,14,14,13,7,7,7,6,7,7,7,7,7,7,7,7,38.9070000648499,NA,NA,"","",NA
"337",14,14,14,14,11,5,7,7,4,1,7,7,7,7,4,7,7,7,87.1629998683929,66,"male","Honduras","Licenciatura",NA
"338",14,10,14,13,12,14,6,7,7,7,7,7,7,7,6,6,5,5,80.3239998817444,72,"other","Afganistán","Licenciatura",NA
"342",13,10,7,11,9,6,5,6,3,3,3,4,6,7,6,3,5,5,106.932999849319,NA,NA,"","",NA
"343",12,11,10,14,3,2,7,7,1,1,4,6,6,6,2,1,5,6,44.7049999237061,69,NA,"Uruguay","Grado profesional",1
"344",13,12,13,13,14,12,6,7,6,6,6,7,7,6,7,7,7,5,41.577999830246,58,"male","Venezuela (República Bolivariana de)","Bachillerato",1
"345",14,10,14,14,14,14,7,7,7,7,7,7,7,7,7,7,3,7,91.4680001735687,67,"male","Argentina","Bachillerato",1
"347",11,8,7,10,8,8,5,5,3,5,4,3,5,6,4,4,4,4,35.164999961853,18,"male","Nicaragua","Bachillerato",7
"348",14,14,14,12,14,2,5,7,1,1,7,7,7,7,7,7,7,7,93.5900001525879,65,NA,"Bolivia (Estado Plurinacional de)","Licenciatura",1
"354",11,9,12,13,13,2,7,6,1,1,6,6,6,5,7,6,4,5,112.40499997139,47,"female","Venezuela (República Bolivariana de)","Bachillerato",7
"357",14,4,14,14,10,14,7,7,7,7,7,7,7,7,5,5,3,1,84.2230000495911,60,"female","El Salvador","Licenciatura",7
"358",14,12,12,12,13,10,6,6,6,4,6,6,7,7,6,7,6,6,52.5730001926422,72,NA,"Argentina","Licenciatura",5
"359",12,9,11,11,10,8,6,5,4,4,6,5,6,6,5,5,4,5,80.4739999771118,63,NA,"Argentina","Formación comercial/técnica/vocacional",4
"360",14,14,13,12,12,3,6,6,2,1,7,6,7,7,6,6,7,7,118.680000066757,66,"male","","",NA
"361",14,14,12,13,13,2,6,7,1,1,6,6,7,7,6,7,7,7,119.483999967575,24,"male","","Bachillerato",NA
"362",12,14,12,11,12,9,4,7,4,5,7,5,7,5,5,7,7,7,123.510000228882,18,"female","Venezuela (República Bolivariana de)","Bachillerato",5
"363",12,9,13,12,12,11,6,6,6,5,6,7,6,6,6,6,4,5,91.6819999217987,25,NA,"Bolivia (Estado Plurinacional de)","Grado de asociado",NA
"364",13,4,14,13,11,12,6,7,7,5,7,7,6,7,4,7,3,1,44.6640000343323,50,"female","Argentina","Grado de asociado",1
"365",14,14,14,14,6,14,7,7,7,7,7,7,7,7,3,3,7,7,57.5659999847412,46,"male","Argentina","Grado de asociado",5
"366",13,14,13,12,12,8,6,6,3,5,7,6,7,6,6,6,7,7,120.860000133514,47,"male","Colombia","Bachillerato",2
"368",11,10,14,13,14,4,6,7,3,1,7,7,6,5,7,7,5,5,74.2850000858307,43,"female","Argentina","Bachillerato",1
"369",14,13,14,14,11,13,7,7,7,6,7,7,7,7,6,5,7,6,81.9919998645782,71,NA,"Argentina","",NA
"371",13,10,9,11,13,8,4,7,4,4,5,4,7,6,7,6,5,5,68.7509999275208,45,"female","Argentina","Bachillerato",1
"372",14,14,12,13,14,5,6,7,4,1,7,5,7,7,7,7,7,7,116.705000162125,NA,NA,"","",NA
"373",14,14,14,14,10,9,7,7,6,3,7,7,7,7,5,5,7,7,42.5609998703003,25,"female","Venezuela (República Bolivariana de)","Bachillerato",1
"374",14,13,12,13,13,13,6,7,6,7,6,6,7,7,6,7,7,6,110.401000022888,68,"female","","",4
"376",8,8,8,7,8,7,3,4,3,4,4,4,4,4,4,4,4,4,69.2820000648499,72,"female","Argentina","",2
"377",9,12,14,13,14,12,6,7,6,6,7,7,6,3,7,7,6,6,128.065999984741,54,"female","Venezuela (República Bolivariana de)","Grado profesional",1
"378",14,14,13,13,8,13,7,6,7,6,6,7,7,7,4,4,7,7,62.4470000267029,60,"male","Argentina","Grado profesional",1
"379",13,12,6,12,9,13,6,6,6,7,4,2,7,6,7,2,6,6,88.3689999580383,NA,NA,"","",NA
"380",14,12,14,14,12,12,7,7,5,7,7,7,7,7,6,6,6,6,78.3129997253418,67,"male","","",NA
"382",14,14,14,14,14,11,7,7,4,7,7,7,7,7,7,7,7,7,101.401999950409,47,NA,"Venezuela (República Bolivariana de)","Maestría",1
"383",14,13,8,12,4,13,6,6,7,6,2,6,7,7,2,2,7,6,54.8770000934601,NA,NA,"","",NA
"384",12,12,10,12,12,8,5,7,5,3,3,7,7,5,5,7,5,7,68.2290000915527,53,"female","","Bachillerato",NA
"385",14,14,14,14,14,7,7,7,6,1,7,7,7,7,7,7,7,7,55.2659997940063,65,"female","Colombia","Formación comercial/técnica/vocacional",NA
"386",11,14,10,11,12,7,4,7,1,6,6,4,7,4,6,6,7,7,105.400000095367,45,"female","Venezuela (República Bolivariana de)","Licenciatura",3
"387",10,8,14,13,4,7,7,6,6,1,7,7,6,4,3,1,2,6,53.2789998054504,22,"female","Uruguay","Bachillerato",3
"389",10,10,14,14,14,7,7,7,6,1,7,7,5,5,7,7,5,5,38.6059999465942,18,"male","México","Bachillerato",7
"391",13,6,12,10,10,4,4,6,1,3,6,6,6,7,5,5,3,3,102.482999801636,59,"female","Argentina","",4
"393",13,12,7,13,5,6,6,7,4,2,3,4,6,7,4,1,6,6,110.163000106812,55,"female","República Dominicana","Licenciatura",1
"395",13,2,13,14,14,10,7,7,6,4,6,7,6,7,7,7,1,1,54.1560001373291,51,"female","Bolivia (Estado Plurinacional de)","Licenciatura",7
"396",14,10,14,14,11,11,7,7,7,4,7,7,7,7,5,6,5,5,126.926000118256,70,"female","Argentina","Formación comercial/técnica/vocacional",5
"399",13,8,14,14,14,4,7,7,1,3,7,7,7,6,7,7,4,4,89.2330000400543,NA,NA,"","",NA
"400",10,11,12,14,12,12,7,7,7,5,7,5,5,5,6,6,6,5,54.7180001735687,49,"male","Argentina","Licenciatura",3
"401",11,7,7,9,10,8,5,4,5,3,3,4,6,5,5,5,3,4,65.9200000762939,50,NA,"Argentina","Grado profesional",2
"403",14,8,14,14,14,14,7,7,7,7,7,7,7,7,7,7,1,7,48.4030001163483,NA,NA,"","",NA
"404",14,14,14,14,5,2,7,7,1,1,7,7,7,7,4,1,7,7,60.9290001392365,64,NA,"","Formación comercial/técnica/vocacional",NA
"405",7,8,10,11,9,8,5,6,3,5,6,4,6,1,5,4,4,4,73.0450000762939,87,NA,"Argentina","Bachillerato",NA
"407",9,8,10,14,14,2,7,7,1,1,5,5,4,5,7,7,4,4,49.5709998607635,35,"male","República Dominicana","Bachillerato",2
"408",13,12,12,12,8,7,6,6,5,2,6,6,6,7,5,3,6,6,66.8670001029968,75,"female","","",5
"409",14,14,14,10,5,4,5,5,3,1,7,7,7,7,4,1,7,7,54.5999999046326,26,NA,"El Salvador","Doctorado",7
"411",6,6,7,14,12,2,7,7,1,1,2,5,3,3,6,6,3,3,59.5599999427795,NA,NA,"","",NA
"413",13,13,10,11,7,9,5,6,4,5,6,4,7,6,3,4,7,6,107.753000259399,38,"female","Honduras","",NA
"414",14,14,14,14,14,4,7,7,3,1,7,7,7,7,7,7,7,7,36.7369999885559,58,NA,"Argentina","Formación comercial/técnica/vocacional",7
"415",14,14,14,14,7,4,7,7,3,1,7,7,7,7,4,3,7,7,60.6129999160767,56,"male","Colombia","Bachillerato",1
"417",14,14,13,14,13,12,7,7,5,7,7,6,7,7,6,7,7,7,110.44300031662,48,NA,"Argentina","Bachillerato",3
"419",13,14,12,14,14,5,7,7,4,1,6,6,7,6,7,7,7,7,70.5060000419617,42,"male","Venezuela (República Bolivariana de)","Licenciatura",1
"420",13,12,12,12,10,9,6,6,5,4,6,6,7,6,4,6,6,6,36.3599998950958,47,"male","Venezuela (República Bolivariana de)","Formación comercial/técnica/vocacional",1
"421",11,10,14,14,13,3,7,7,1,2,7,7,6,5,7,6,4,6,75.8200001716614,30,"female","Venezuela (República Bolivariana de)","Bachillerato",1
"422",12,10,13,10,13,10,5,5,5,5,7,6,6,6,7,6,5,5,113.634999990463,33,"female","Venezuela (República Bolivariana de)","Bachillerato",2
"423",14,14,4,12,10,4,5,7,2,2,3,1,7,7,5,5,7,7,80.4409999847412,60,"female","Colombia","Licenciatura",1
"424",14,9,14,3,5,2,1,2,1,1,7,7,7,7,4,1,5,4,75.0940001010895,70,"female","Argentina","",7
"425",14,10,14,14,14,14,7,7,7,7,7,7,7,7,7,7,5,5,53.5659999847412,50,"female","Argentina","Formación comercial/técnica/vocacional",3
"426",14,14,8,14,14,2,7,7,1,1,7,1,7,7,7,7,7,7,73.0229997634888,NA,NA,"","",NA
"431",13,7,14,13,14,6,6,7,1,5,7,7,7,6,7,7,4,3,117.019999980927,NA,NA,"","",NA
"433",14,5,11,14,14,2,7,7,1,1,4,7,7,7,7,7,4,1,107.249000072479,NA,NA,"","",NA
"434",14,12,14,7,11,5,3,4,4,1,7,7,7,7,4,7,6,6,86.8810000419617,44,"female","Argentina","Grado profesional",1
"435",13,12,14,13,12,14,6,7,7,7,7,7,7,6,6,6,6,6,31.0939998626709,26,NA,"Bolivia (Estado Plurinacional de)","Licenciatura",3
"438",10,10,9,9,10,7,4,5,1,6,6,3,5,5,5,5,5,5,71.8710000514984,64,"male","Costa Rica","Formación comercial/técnica/vocacional",NA
"439",8,10,11,10,12,10,5,5,5,5,6,5,5,3,7,5,5,5,36.4049999713898,45,NA,"Bolivia (Estado Plurinacional de)","Licenciatura",2
"440",14,13,13,13,11,6,6,7,1,5,6,7,7,7,5,6,6,7,105.671999931335,53,"female","Argentina","Formación comercial/técnica/vocacional",2
"442",14,14,14,14,14,2,7,7,1,1,7,7,7,7,7,7,7,7,56.5039999485016,52,"female","Venezuela (República Bolivariana de)","",NA
"443",14,3,14,14,14,12,7,7,6,6,7,7,7,7,7,7,1,2,55.760999917984,28,"male","Venezuela (República Bolivariana de)","Bachillerato",NA
"444",14,13,14,14,13,10,7,7,5,5,7,7,7,7,6,7,6,7,61.614000082016,68,"female","Chile","Bachillerato",2
"448",14,11,12,14,13,2,7,7,1,1,5,7,7,7,6,7,6,5,91.9570000171661,41,"female","","Formación comercial/técnica/vocacional",4
"449",14,6,13,11,10,5,5,6,3,2,6,7,7,7,4,6,4,2,93.489000082016,19,"male","Nicaragua","Bachillerato",2
"450",8,13,14,14,8,2,7,7,1,1,7,7,1,7,3,5,7,6,93.8929998874664,60,NA,"Venezuela (República Bolivariana de)","Licenciatura",2
"451",8,11,5,7,7,11,4,3,6,5,1,4,2,6,6,1,5,6,100.494000196457,31,"female","Venezuela (República Bolivariana de)","",NA
"453",14,14,14,14,14,6,7,7,2,4,7,7,7,7,7,7,7,7,59.6510000228882,49,"female","Venezuela (República Bolivariana de)","Formación comercial/técnica/vocacional",NA
"454",14,7,14,14,8,5,7,7,4,1,7,7,7,7,4,4,4,3,122.125999927521,NA,NA,"","",NA
"456",13,14,14,12,13,10,6,6,5,5,7,7,7,6,7,6,7,7,68.6419999599457,74,"female","Uruguay","Bachillerato",1
"461",14,10,14,14,14,10,7,7,4,6,7,7,7,7,7,7,5,5,61.8480000495911,41,NA,"Argentina","Bachillerato",1
"462",14,12,13,12,9,10,6,6,4,6,6,7,7,7,5,4,6,6,58.5989999771118,71,"male","Argentina","Grado profesional",1
"463",14,14,11,14,6,8,7,7,4,4,4,7,7,7,5,1,7,7,46.3650002479553,NA,NA,"","",NA
"465",14,14,14,14,13,9,7,7,6,3,7,7,7,7,6,7,7,7,53.6630001068115,60,"female","Colombia","",1
"466",13,12,12,13,13,6,6,7,5,1,6,6,7,6,6,7,6,6,64.0969998836517,40,"male","Bolivia (Estado Plurinacional de)","Licenciatura",2
"467",14,14,14,14,14,6,7,7,5,1,7,7,7,7,7,7,7,7,71.2269999980927,22,"female","Venezuela (República Bolivariana de)","Bachillerato",1
"468",14,14,8,12,14,6,5,7,5,1,1,7,7,7,7,7,7,7,70.1950001716614,29,"male","Venezuela (República Bolivariana de)","Bachillerato",3
"469",14,11,14,10,14,8,5,5,6,2,7,7,7,7,7,7,6,5,51.7760000228882,45,NA,"Venezuela (República Bolivariana de)","Grado profesional",3
"471",14,14,14,14,14,2,7,7,1,1,7,7,7,7,7,7,7,7,74.9940001964569,54,"male","Venezuela (República Bolivariana de)","Bachillerato",7
"472",14,8,14,14,14,11,7,7,7,4,7,7,7,7,7,7,4,4,59.8550000190735,26,"male","Colombia","Bachillerato",7
"473",14,14,14,14,13,13,7,7,7,6,7,7,7,7,6,7,7,7,137.972999811172,53,"female","Argentina","Grado profesional",5
"474",12,12,14,14,14,14,7,7,7,7,7,7,7,5,7,7,6,6,45.3040001392365,40,NA,"Uruguay","Grado profesional",5
"476",14,13,14,13,11,3,6,7,1,2,7,7,7,7,6,5,7,6,58.6730000972748,60,"female","Chile","Formación comercial/técnica/vocacional",5
"481",14,13,14,14,14,13,7,7,6,7,7,7,7,7,7,7,7,6,48.9889998435974,22,"male","Venezuela (República Bolivariana de)","Bachillerato",3
"482",12,11,14,11,7,7,6,5,3,4,7,7,6,6,4,3,5,6,56.2450001239777,21,"female","Honduras","Bachillerato",1
"483",12,10,13,12,9,5,5,7,2,3,6,7,6,6,6,3,4,6,94.9909999370575,65,"male","Bolivia (Estado Plurinacional de)","Licenciatura",1
"484",14,14,14,14,14,2,7,7,1,1,7,7,7,7,7,7,7,7,54.9500000476837,40,"female","Nicaragua","Licenciatura",1
"485",12,14,14,13,14,6,6,7,5,1,7,7,7,5,7,7,7,7,67.7460000514984,29,"female","Bolivia (Estado Plurinacional de)","Licenciatura",NA
"486",14,12,10,8,6,4,4,4,2,2,5,5,7,7,3,3,6,6,95.0929999351501,22,"female","República Dominicana","Bachillerato",3
"492",14,14,14,14,12,8,7,7,4,4,7,7,7,7,7,5,7,7,140.487999916077,27,"male","Bolivia (Estado Plurinacional de)","Bachillerato",1
"495",12,5,12,14,11,4,7,7,1,3,6,6,6,6,5,6,3,2,76.2740001678467,55,"female","Argentina","Bachillerato",1
"496",11,10,12,13,10,5,7,6,4,1,6,6,6,5,6,4,5,5,77.4549999237061,55,"male","Venezuela (República Bolivariana de)","Formación comercial/técnica/vocacional",NA
"504",11,14,12,13,12,6,6,7,4,2,6,6,7,4,5,7,7,7,65.319000005722,39,"female","Venezuela (República Bolivariana de)","Formación comercial/técnica/vocacional",1
"508",13,12,14,12,13,5,6,6,2,3,7,7,6,7,6,7,6,6,83.7829999923706,44,"female","Nicaragua","Licenciatura",2
"510",11,9,12,11,14,13,5,6,7,6,6,6,6,5,7,7,5,4,64.7369999885559,24,"female","Bolivia (Estado Plurinacional de)","Bachillerato",1
"511",12,9,12,12,10,7,6,6,4,3,6,6,6,6,5,5,4,5,91.6579999923706,62,"female","Venezuela (República Bolivariana de)","Bachillerato",3
"518",14,14,14,14,14,2,7,7,1,1,7,7,7,7,7,7,7,7,74.345999956131,37,"female","Venezuela (República Bolivariana de)","Formación comercial/técnica/vocacional",1
"522",14,13,14,12,12,2,5,7,1,1,7,7,7,7,5,7,6,7,65.2919998168945,20,"female","Venezuela (República Bolivariana de)","Bachillerato",1
"524",14,13,14,11,9,9,5,6,5,4,7,7,7,7,5,4,6,7,75.3580002784729,65,"female","Venezuela (República Bolivariana de)","Bachillerato",5
"527",12,11,9,11,10,6,5,6,3,3,5,4,6,6,6,4,6,5,57.0900001525879,61,"male","Argentina","Grado profesional",NA
"528",14,14,14,14,14,2,7,7,1,1,7,7,7,7,7,7,7,7,52.2159998416901,36,"female","Venezuela (República Bolivariana de)","Grado profesional",3
"529",14,11,10,6,4,2,3,3,1,1,5,5,7,7,2,2,6,5,72.3899998664856,19,"male","República Dominicana","Bachillerato",5
"535",14,14,12,12,14,8,6,6,4,4,6,6,7,7,7,7,7,7,49.441999912262,20,"female","Guatemala","Bachillerato",1
"536",12,11,12,12,12,9,6,6,3,6,6,6,6,6,6,6,5,6,48.7769999504089,33,"female","Colombia","Bachillerato",1
"537",14,14,10,13,14,4,6,7,1,3,7,3,7,7,7,7,7,7,65.7559998035431,64,"female","Nicaragua","Bachillerato",1
"538",11,8,12,14,11,5,7,7,2,3,6,6,6,5,5,6,4,4,80.1319999694824,22,"female","Bolivia (Estado Plurinacional de)","Formación comercial/técnica/vocacional",1
"539",11,12,14,12,12,2,5,7,1,1,7,7,6,5,6,6,6,6,103.699999809265,18,"female","Bolivia (Estado Plurinacional de)","Formación comercial/técnica/vocacional",1
"540",14,6,12,8,8,13,4,4,7,6,5,7,7,7,2,6,3,3,50.1570000648499,NA,NA,"","",NA
"542",14,5,14,14,13,13,7,7,7,6,7,7,7,7,7,6,1,4,53.0490000247955,NA,NA,"","",NA
"543",12,9,14,11,7,11,5,6,6,5,7,7,6,6,3,4,4,5,63.8409998416901,39,"female","Venezuela (República Bolivariana de)","Formación comercial/técnica/vocacional",7
"547",14,10,12,13,13,11,6,7,5,6,6,6,7,7,7,6,4,6,62.6280000209808,22,"female","Bolivia (Estado Plurinacional de)","Bachillerato",1
"550",14,12,14,14,14,14,7,7,7,7,7,7,7,7,7,7,5,7,58.4200000762939,58,"female","","Bachillerato",1
"554",13,8,14,12,14,3,5,7,2,1,7,7,7,6,7,7,4,4,80.7449998855591,21,"female","Venezuela (República Bolivariana de)","Bachillerato",2
"557",14,14,13,12,14,6,5,7,4,2,6,7,7,7,7,7,7,7,51.3470001220703,40,"female","Venezuela (República Bolivariana de)","Formación comercial/técnica/vocacional",1
"560",14,12,13,12,11,11,5,7,7,4,6,7,7,7,5,6,5,7,80.2990000247955,19,"female","Venezuela (República Bolivariana de)","Bachillerato",1
"561",11,12,12,12,13,13,5,7,7,6,6,6,6,5,6,7,6,6,36.0239999294281,20,"female","Guatemala","Licenciatura",1
"563",14,14,14,13,13,7,7,6,5,2,7,7,7,7,7,6,7,7,96.1500000953674,39,"male","Bolivia (Estado Plurinacional de)","Licenciatura",1
"564",10,9,14,13,13,10,6,7,5,5,7,7,6,4,7,6,6,3,51.4020001888275,25,"female","Perú","Licenciatura",NA
"571",14,14,14,14,14,10,7,7,7,3,7,7,7,7,7,7,7,7,54.3509998321533,40,"female","Nicaragua","Licenciatura",1
"573",13,11,12,13,9,9,6,7,4,5,6,6,6,7,3,6,6,5,79.7850000858307,65,"female","Venezuela (República Bolivariana de)","Maestría",3
"574",6,8,14,13,14,14,6,7,7,7,7,7,4,2,7,7,4,4,60.2130000591278,27,"female","Venezuela (República Bolivariana de)","Formación comercial/técnica/vocacional",1
"575",13,11,14,14,14,5,7,7,4,1,7,7,7,6,7,7,5,6,143.519000053406,34,"female","Bolivia (Estado Plurinacional de)","Formación comercial/técnica/vocacional",1
"578",13,6,14,13,14,11,6,7,6,5,7,7,7,6,7,7,5,1,54.2829999923706,22,"male","Colombia","Bachillerato",1
"579",14,12,14,13,12,6,7,6,5,1,7,7,7,7,6,6,5,7,87.5460000038147,38,"female","Venezuela (República Bolivariana de)","Licenciatura",1
"580",13,13,13,12,14,8,5,7,5,3,6,7,7,6,7,7,7,6,58.805999994278,25,"female","España","Licenciatura",1
"582",12,9,11,12,10,7,6,6,4,3,5,6,6,6,5,5,5,4,45.2369999885559,NA,NA,"","",NA
"583",11,14,13,14,10,7,7,7,4,3,6,7,5,6,5,5,7,7,51.8610000610352,24,"female","Bolivia (Estado Plurinacional de)","Licenciatura",1
"586",14,14,14,13,12,2,6,7,1,1,7,7,7,7,6,6,7,7,36.7309999465942,21,"female","","",NA
"588",10,6,14,11,12,2,4,7,1,1,7,7,6,4,5,7,2,4,43.2839999198914,25,NA,"Guatemala","Bachillerato",3
"589",13,13,14,14,14,9,7,7,6,3,7,7,7,6,7,7,6,7,64.8619999885559,NA,NA,"","",NA
"590",14,14,14,14,14,2,7,7,1,1,7,7,7,7,7,7,7,7,58.7039999961853,26,"female","Venezuela (República Bolivariana de)","",5
"592",12,8,12,13,11,10,6,7,6,4,6,6,6,6,5,6,4,4,52.8610000610352,NA,NA,"","",NA
"596",12,10,10,11,7,5,4,7,4,1,5,5,7,5,4,3,5,5,48.7969999313354,20,"female","Nicaragua","Licenciatura",NA
"597",13,14,14,14,14,11,7,7,6,5,7,7,7,6,7,7,7,7,65.6539998054504,21,"male","Venezuela (República Bolivariana de)","Bachillerato",4
"599",11,10,13,9,11,11,4,5,4,7,7,6,7,4,7,4,4,6,65.6189999580383,25,"female","Venezuela (República Bolivariana de)","Bachillerato",2
"600",9,8,14,14,11,10,7,7,6,4,7,7,5,4,4,7,4,4,58.5479998588562,22,"male","Guatemala","Bachillerato",7
"601",14,14,14,14,10,4,7,7,3,1,7,7,7,7,5,5,7,7,123.40700006485,39,"male","Venezuela (República Bolivariana de)","Formación comercial/técnica/vocacional",1
"602",12,11,11,12,11,7,6,6,2,5,6,5,7,5,5,6,6,5,109.564999818802,36,"female","Bolivia (Estado Plurinacional de)","Licenciatura",3
"603",10,2,12,14,10,8,7,7,4,4,5,7,7,3,7,3,1,1,72.0609998703003,18,"female","Bolivia (Estado Plurinacional de)","Bachillerato",1
"604",14,10,14,12,13,8,6,6,4,4,7,7,7,7,7,6,3,7,68.3819999694824,28,NA,"Venezuela (República Bolivariana de)","Formación comercial/técnica/vocacional",NA
"605",13,13,13,14,12,10,7,7,5,5,6,7,7,6,6,6,7,6,52.1949999332428,60,"female","Venezuela (República Bolivariana de)","Bachillerato",7
"606",14,14,14,14,14,2,7,7,1,1,7,7,7,7,7,7,7,7,54.1819999217987,63,"male","Venezuela (República Bolivariana de)","Maestría",2
"607",12,12,13,12,9,9,6,6,4,5,6,7,6,6,6,3,6,6,72.2700002193451,28,"male","Brasil","Formación comercial/técnica/vocacional",1
"609",13,13,13,12,9,12,6,6,6,6,6,7,7,6,2,7,7,6,57.1319999694824,22,"male","Bolivia (Estado Plurinacional de)","Licenciatura",2
"610",14,14,13,12,12,6,5,7,3,3,6,7,7,7,5,7,7,7,74.8109998703003,47,NA,"Venezuela (República Bolivariana de)","Bachillerato",1
"612",12,4,14,13,14,8,6,7,3,5,7,7,7,5,7,7,2,2,80.4629998207092,20,NA,"Bolivia (Estado Plurinacional de)","Formación comercial/técnica/vocacional",1
"614",11,10,10,11,14,10,4,7,6,4,4,6,6,5,7,7,4,6,39.6949999332428,20,"female","Venezuela (República Bolivariana de)","Bachillerato",NA
"616",14,13,14,14,14,14,7,7,7,7,7,7,7,7,7,7,7,6,73.9019999504089,26,"male","Argentina","Bachillerato",1
"618",9,9,14,10,6,11,5,5,6,5,7,7,5,4,4,2,4,5,64.4800000190735,71,NA,"Argentina","Licenciatura",7
"619",14,9,12,12,10,10,6,6,6,4,6,6,7,7,6,4,3,6,82.6399998664856,20,"male","Bolivia (Estado Plurinacional de)","Bachillerato",5
"622",13,11,14,14,13,9,7,7,5,4,7,7,7,6,6,7,7,4,54.7360000610352,29,"male","","Formación comercial/técnica/vocacional",4
"624",13,11,14,13,13,7,6,7,5,2,7,7,7,6,7,6,5,6,41.0280001163483,NA,NA,"","",NA
"632",12,9,12,12,11,6,7,5,4,2,7,5,7,5,4,7,4,5,71.4309997558594,28,"male","Venezuela (República Bolivariana de)","Formación comercial/técnica/vocacional",4
"634",13,10,14,12,11,11,6,6,5,6,7,7,6,7,6,5,5,5,64.1359996795654,26,NA,"Nicaragua","Licenciatura",2
"636",14,14,14,14,14,2,7,7,1,1,7,7,7,7,7,7,7,7,55.3919999599457,21,"female","Venezuela (República Bolivariana de)","Bachillerato",2
"638",9,12,14,14,14,9,7,7,4,5,7,7,4,5,7,7,5,7,44.5659999847412,21,NA,"Bolivia (Estado Plurinacional de)","Formación comercial/técnica/vocacional",5
"640",11,10,13,12,14,4,6,6,2,2,7,6,6,5,7,7,6,4,39.558000087738,19,"female","Bolivia (Estado Plurinacional de)","Grado profesional",2
"642",12,13,14,13,13,7,6,7,6,1,7,7,6,6,6,7,7,6,65.25,35,"male","Bolivia (Estado Plurinacional de)","Licenciatura",NA
"644",10,9,12,9,11,7,4,5,3,4,5,7,5,5,6,5,5,4,37.5390000343323,24,"female","Venezuela (República Bolivariana de)","Bachillerato",1
"645",14,14,14,11,8,7,7,4,4,3,7,7,7,7,4,4,7,7,55.4760000705719,36,"male","Argentina","Bachillerato",4
"648",14,8,12,14,14,6,7,7,1,5,5,7,7,7,7,7,5,3,109.675000190735,32,"female","Venezuela (República Bolivariana de)","Bachillerato",1
"650",13,13,12,14,11,9,7,7,7,2,5,7,7,6,4,7,6,7,79.1000001430511,19,"female","Bolivia (Estado Plurinacional de)","Bachillerato",1
"652",10,13,13,14,13,13,7,7,7,6,6,7,7,3,7,6,7,6,49.6760001182556,19,"male","Venezuela (República Bolivariana de)","Grado profesional",4
"655",14,14,14,14,5,2,7,7,1,1,7,7,7,7,4,1,7,7,109.792999744415,27,"female","Bolivia (Estado Plurinacional de)","Bachillerato",1
"656",14,9,8,11,14,6,6,5,3,3,5,3,7,7,7,7,3,6,113.633000135422,23,"female","Venezuela (República Bolivariana de)","Licenciatura",1
"657",14,13,14,14,14,5,7,7,1,4,7,7,7,7,7,7,6,7,52.5290002822876,22,"female","Venezuela (República Bolivariana de)","Bachillerato",1
"658",14,12,14,13,14,5,6,7,4,1,7,7,7,7,7,7,6,6,37.9210000038147,NA,NA,"","",NA
"660",13,12,14,13,14,11,7,6,7,4,7,7,7,6,7,7,6,6,44.3059997558594,19,"female","Guatemala","Licenciatura",1
"661",14,13,7,12,8,4,6,6,1,3,4,3,7,7,5,3,6,7,98.0139999389648,19,"male","El Salvador","Bachillerato",2
"663",13,12,13,13,14,12,6,7,6,6,7,6,7,6,7,7,6,6,94.4180002212524,NA,NA,"","",NA
"664",12,13,14,12,13,12,6,6,6,6,7,7,7,5,7,6,6,7,54.4260001182556,19,"female","Guatemala","Bachillerato",2
"665",11,11,14,13,13,10,6,7,6,4,7,7,6,5,6,7,6,5,39.4670000076294,NA,"male","Argentina","Maestría",5
"666",14,12,14,12,14,12,6,6,6,6,7,7,7,7,7,7,6,6,80.8790001869202,20,"female","Bolivia (Estado Plurinacional de)","Bachillerato",1
"668",11,11,11,14,11,2,7,7,1,1,4,7,7,4,7,4,7,4,55.6930003166199,24,"male","Venezuela (República Bolivariana de)","Bachillerato",1
"671",14,14,14,11,8,10,5,6,5,5,7,7,7,7,3,5,7,7,96.5880000591278,30,"female","Venezuela (República Bolivariana de)","Licenciatura",1
"672",13,13,14,12,14,4,6,6,3,1,7,7,7,6,7,7,7,6,43.2649998664856,NA,"female","Bolivia (Estado Plurinacional de)","Bachillerato",3
"673",10,12,14,13,11,9,6,7,4,5,7,7,5,5,6,5,6,6,90.3719999790192,39,"female","Argentina","Licenciatura",2
"676",14,2,14,11,14,14,4,7,7,7,7,7,7,7,7,7,1,1,56.7179999351501,25,"female","Argentina","Bachillerato",1
"677",11,6,9,11,11,7,6,5,4,3,3,6,5,6,5,6,3,3,39.3680000305176,22,"female","Argentina","Bachillerato",3
"678",14,13,14,14,13,2,7,7,1,1,7,7,7,7,7,6,6,7,73.7690000534058,23,"female","Nicaragua","Grado de asociado",6
"682",14,10,14,12,13,7,7,5,1,6,7,7,7,7,7,6,6,4,89.8340001106262,20,"male","Argentina","Bachillerato",1
"683",10,8,14,13,12,7,6,7,3,4,7,7,6,4,6,6,3,5,71.5799999237061,28,"male","Guatemala","Bachillerato",5
"685",14,12,13,10,14,6,5,5,2,4,7,6,7,7,7,7,7,5,54.311999797821,24,"female","Bolivia (Estado Plurinacional de)","Grado de asociado",4
"686",12,9,13,12,12,7,5,7,3,4,7,6,6,6,5,7,5,4,46.6999998092651,26,"female","Argentina","Grado profesional",7
"687",12,7,14,12,11,5,6,6,2,3,7,7,7,5,6,5,3,4,35.691999912262,32,"female","Argentina","Grado profesional",NA
"690",12,13,13,13,13,9,7,6,2,7,7,6,6,6,7,6,7,6,59.0179998874664,30,NA,"Honduras","Licenciatura",3
"691",14,14,14,14,14,11,7,7,4,7,7,7,7,7,7,7,7,7,128.008999824524,22,"male","Bolivia (Estado Plurinacional de)","Bachillerato",1
"693",13,13,14,14,14,12,7,7,7,5,7,7,7,6,7,7,7,6,46.0249998569489,23,"female","Venezuela (República Bolivariana de)","Grado profesional",5
"694",10,8,10,11,13,12,4,7,7,5,7,3,6,4,6,7,4,4,39.2640001773834,20,"male","Guatemala","Bachillerato",5
"695",13,12,14,14,14,13,7,7,7,6,7,7,7,6,7,7,6,6,82.246000289917,NA,NA,"","",NA
"697",13,13,13,13,10,5,6,7,2,3,6,7,7,6,3,7,7,6,51.4140000343323,21,"male","Bolivia (Estado Plurinacional de)","Bachillerato",3
"698",13,13,14,13,14,7,6,7,5,2,7,7,7,6,7,7,6,7,128.84299993515,18,"female","Bolivia (Estado Plurinacional de)","Bachillerato",2
"700",13,6,13,14,12,6,7,7,3,3,6,7,7,6,7,5,4,2,47.5329999923706,NA,NA,"","",NA
"701",13,12,12,13,11,9,6,7,4,5,6,6,7,6,5,6,6,6,105.30999994278,18,"male","Venezuela (República Bolivariana de)","Formación comercial/técnica/vocacional",3
"702",14,12,14,13,14,14,6,7,7,7,7,7,7,7,7,7,5,7,50.0349998474121,24,"male","","Formación comercial/técnica/vocacional",6
"705",14,14,14,14,14,2,7,7,1,1,7,7,7,7,7,7,7,7,66.585000038147,22,"other","Honduras","Bachillerato",5
"706",12,12,14,14,13,13,7,7,7,6,7,7,6,6,7,6,6,6,75.7639999389648,72,"male","Argentina","Grado profesional",1
"709",14,14,14,14,14,11,7,7,7,4,7,7,7,7,7,7,7,7,46.425999879837,NA,NA,"","",NA
"710",14,8,14,14,14,14,7,7,7,7,7,7,7,7,7,7,4,4,83.4349999427795,24,"male","Bolivia (Estado Plurinacional de)","Bachillerato",4
"712",2,4,3,14,12,10,7,7,5,5,1,2,1,1,6,6,2,2,105.498000144958,22,"male","Ecuador","Bachillerato",2
"713",8,14,14,14,14,14,7,7,7,7,7,7,7,1,7,7,7,7,68.8850002288818,29,"male","Bolivia (Estado Plurinacional de)","Bachillerato",1
"719",10,11,11,14,14,5,7,7,1,4,7,4,7,3,7,7,7,4,41.074000120163,22,"female","Nicaragua","Licenciatura",1
"720",12,9,14,13,12,9,6,7,5,4,7,7,6,6,6,6,4,5,75.2769999504089,24,"male","Venezuela (República Bolivariana de)","Licenciatura",5
"724",6,7,13,8,14,2,3,5,1,1,7,6,2,4,7,7,5,2,45.1810002326965,50,NA,"Chile","Formación comercial/técnica/vocacional",3
"726",13,11,14,14,11,10,7,7,4,6,7,7,7,6,4,7,6,5,46.1369998455048,31,"male","Argentina","Licenciatura",3
"727",14,14,14,14,14,2,7,7,1,1,7,7,7,7,7,7,7,7,108.041999816895,41,"female","Venezuela (República Bolivariana de)","Grado profesional",NA
"731",14,14,14,14,14,8,7,7,4,4,7,7,7,7,7,7,7,7,60.0009999275208,40,"female","","Bachillerato",1
"732",12,12,14,13,13,14,6,7,7,7,7,7,6,6,7,6,6,6,87.9730000495911,NA,NA,"","",NA
"733",14,2,11,8,13,10,4,4,3,7,6,5,7,7,6,7,1,1,59.7049999237061,19,NA,"Honduras","Formación comercial/técnica/vocacional",6
"734",8,12,9,11,10,9,5,6,7,2,6,3,2,6,4,6,7,5,141.167999982834,48,"male","Argentina","Grado de asociado",2
"735",8,7,14,14,11,2,7,7,1,1,7,7,3,5,4,7,3,4,63.8249998092651,28,"female","Venezuela (República Bolivariana de)","Licenciatura",4
"736",14,8,14,12,8,11,6,6,6,5,7,7,7,7,4,4,4,4,63.1910002231598,29,"female","Nicaragua","Licenciatura",3
"737",14,6,14,14,14,11,7,7,4,7,7,7,7,7,7,7,2,4,48.9580001831055,25,"female","Bolivia (Estado Plurinacional de)","Licenciatura",1
"741",12,13,13,14,13,13,7,7,7,6,6,7,7,5,7,6,7,6,42.393000125885,18,"female","Honduras","Bachillerato",1
"745",13,10,13,13,13,8,6,7,5,3,7,6,7,6,6,7,5,5,65.951000213623,23,"male","Honduras","Bachillerato",5
"747",11,9,14,14,10,7,7,7,3,4,7,7,7,4,6,4,4,5,101.855999946594,24,"male","Argentina","Bachillerato",1
"748",11,13,13,13,14,7,6,7,4,3,6,7,6,5,7,7,6,7,47.8499999046326,23,NA,"Nicaragua","Bachillerato",1
"751",11,10,10,10,10,9,5,5,4,5,5,5,6,5,5,5,5,5,66.425999879837,23,"male","Bolivia (Estado Plurinacional de)","Formación comercial/técnica/vocacional",1
"752",13,10,13,11,12,6,5,6,3,3,7,6,6,7,7,5,6,4,77.6929998397827,29,"male","Bolivia (Estado Plurinacional de)","Licenciatura",3
"753",14,8,14,14,7,4,7,7,3,1,7,7,7,7,4,3,4,4,57.558000087738,28,"female","Venezuela (República Bolivariana de)","Bachillerato",1
"754",14,14,14,14,13,2,7,7,1,1,7,7,7,7,7,6,7,7,46.925999879837,19,"female","Nicaragua","Bachillerato",1
"755",12,14,14,14,14,2,7,7,1,1,7,7,6,6,7,7,7,7,82.7439999580383,NA,NA,"","",NA
"756",9,12,14,13,10,5,7,6,4,1,7,7,5,4,5,5,5,7,93.6410000324249,23,"male","Nicaragua","Bachillerato",1
"760",14,14,14,14,2,14,7,7,7,7,7,7,7,7,1,1,7,7,53.8109998703003,18,NA,"Colombia","Grado profesional",3
"762",14,12,14,14,14,4,7,7,3,1,7,7,7,7,7,7,7,5,71.0540001392365,30,NA,"Argentina","Bachillerato",1
"764",2,2,6,12,10,14,6,6,7,7,3,3,1,1,5,5,1,1,80.3599998950958,NA,NA,"","",NA
"765",2,3,6,12,10,14,6,6,7,7,3,3,1,1,5,5,2,1,59.6150002479553,NA,NA,"","",NA
"766",6,2,10,14,4,12,7,7,6,6,5,5,3,3,2,2,1,1,61.4079999923706,NA,NA,"","",NA
"770",8,7,10,13,14,8,6,7,6,2,5,5,4,4,7,7,3,4,56.1439998149872,18,"male","Nicaragua","Bachillerato",5
"771",14,4,14,14,10,3,7,7,1,2,7,7,7,7,3,7,3,1,55.574000120163,19,NA,"Venezuela (República Bolivariana de)","Grado profesional",1
"774",12,10,14,13,10,9,7,6,6,3,7,7,7,5,3,7,5,5,49.2350001335144,21,"male","Argentina","Grado de asociado",1
"775",12,12,14,14,14,14,7,7,7,7,7,7,7,5,7,7,7,5,54.444000005722,18,"female","Venezuela (República Bolivariana de)","Formación comercial/técnica/vocacional",1
"776",13,13,14,14,14,14,7,7,7,7,7,7,7,6,7,7,7,6,66.4279999732971,18,"female","Honduras","Licenciatura",1
"777",14,14,14,14,14,7,7,7,4,3,7,7,7,7,7,7,7,7,86.2730000019073,21,"male","El Salvador","Bachillerato",7
"779",11,8,14,14,13,5,7,7,1,4,7,7,7,4,7,6,4,4,57.3889999389648,23,NA,"Nicaragua","Licenciatura",4
"780",10,10,9,9,13,8,3,6,4,4,4,5,5,5,7,6,6,4,56.1319999694824,NA,NA,"","",NA
"782",14,8,11,14,11,3,7,7,2,1,4,7,7,7,4,7,4,4,76.5370001792908,NA,NA,"","",NA
"786",13,14,14,13,13,11,7,6,7,4,7,7,7,6,7,6,7,7,59.6100001335144,NA,NA,"","",NA
"787",14,13,13,14,12,5,7,7,3,2,7,6,7,7,5,7,7,6,41.1370000839233,20,"male","Venezuela (República Bolivariana de)","Formación comercial/técnica/vocacional",3
"789",12,12,14,14,13,12,7,7,5,7,7,7,6,6,6,7,6,6,95.7730002403259,23,NA,"Venezuela (República Bolivariana de)","Grado profesional",6
"791",13,14,14,12,13,11,6,6,5,6,7,7,7,6,6,7,7,7,70.4730000495911,20,"male","Venezuela (República Bolivariana de)","Bachillerato",1
"792",12,13,13,12,9,12,6,6,6,6,6,7,6,6,7,2,7,6,68.5149998664856,27,NA,"Bolivia (Estado Plurinacional de)","Formación comercial/técnica/vocacional",2
"796",14,14,14,12,14,12,5,7,7,5,7,7,7,7,7,7,7,7,79.6449999809265,32,"male","Venezuela (República Bolivariana de)","Licenciatura",7
"799",9,9,11,11,12,10,5,6,5,5,5,6,5,4,6,6,4,5,84.188000202179,21,"female","Venezuela (República Bolivariana de)","Bachillerato",1
"800",14,14,14,13,14,8,6,7,4,4,7,7,7,7,7,7,7,7,110.59500002861,28,"male","Bolivia (Estado Plurinacional de)","Licenciatura",1
"801",12,12,12,11,12,9,5,6,7,2,6,6,6,6,6,6,6,6,31.6429998874664,36,NA,"Venezuela (República Bolivariana de)","Bachillerato",1
"803",14,11,12,14,14,9,7,7,5,4,5,7,7,7,7,7,6,5,77.5150001049042,18,"male","Nicaragua","Formación comercial/técnica/vocacional",1
"804",4,2,2,14,10,12,7,7,6,6,1,1,2,2,5,5,1,1,51.0510001182556,NA,NA,"","",NA
"805",10,14,6,2,12,12,1,1,6,6,3,3,5,5,6,6,7,7,52.7079997062683,NA,NA,"","",NA
"806",6,2,10,14,4,12,7,7,6,6,5,5,3,3,2,2,1,1,58.7079999446869,NA,NA,"","",NA
"810",14,14,14,14,14,2,7,7,1,1,7,7,7,7,7,7,7,7,103.196000099182,20,"male","Bolivia (Estado Plurinacional de)","Bachillerato",7
"811",14,13,14,14,13,9,7,7,5,4,7,7,7,7,6,7,6,7,126.138000011444,22,"female","Nicaragua","Grado profesional",3
"812",14,2,14,13,14,9,6,7,5,4,7,7,7,7,7,7,1,1,68.039999961853,18,"female","Venezuela (República Bolivariana de)","Bachillerato",NA
"813",14,14,11,14,14,2,7,7,1,1,4,7,7,7,7,7,7,7,61.6679999828339,20,"male","Venezuela (República Bolivariana de)","Bachillerato",3
"814",8,9,14,14,14,8,7,7,2,6,7,7,6,2,7,7,6,3,52.1119999885559,19,"female","Nicaragua","Bachillerato",3
"815",8,10,13,13,14,11,6,7,4,7,6,7,5,3,7,7,6,4,52.8310000896454,21,"female","Nicaragua","Grado profesional",NA
"816",14,13,14,14,14,11,7,7,7,4,7,7,7,7,7,7,7,6,41.6659998893738,19,"male","Bolivia (Estado Plurinacional de)","Bachillerato",1
"819",14,14,14,14,14,2,7,7,1,1,7,7,7,7,7,7,7,7,55.0440001487732,NA,NA,"","",NA
"822",13,7,14,12,9,10,5,7,5,5,7,7,7,6,3,6,4,3,127.350999832153,30,"female","Venezuela (República Bolivariana de)","Bachillerato",NA
"825",10,11,12,12,12,8,6,6,6,2,6,6,5,5,6,6,5,6,123.255999803543,19,"female","Perú","Bachillerato",3
"826",14,14,12,13,14,2,6,7,1,1,7,5,7,7,7,7,7,7,35.1319999694824,20,"female","Colombia","Formación comercial/técnica/vocacional",4
"827",4,2,4,12,10,14,6,6,7,7,2,2,2,2,5,5,1,1,60.9200000762939,21,"male","","",NA
"828",2,2,6,14,10,13,7,7,6,7,3,3,1,1,5,5,1,1,52.2809998989105,18,NA,"","",5
"829",14,10,14,14,14,10,7,7,6,4,7,7,7,7,7,7,4,6,82.1970000267029,22,"female","Colombia","Formación comercial/técnica/vocacional",1
"830",12,7,11,12,13,8,6,6,4,4,5,6,6,6,6,7,4,3,50.1289999485016,NA,"female","Venezuela (República Bolivariana de)","Bachillerato",3
"832",13,8,14,14,14,8,7,7,3,5,7,7,7,6,7,7,3,5,56.1770000457764,26,"female","Venezuela (República Bolivariana de)","Licenciatura",7
"833",14,6,12,7,11,13,3,4,6,7,7,5,7,7,7,4,3,3,62.5460000038147,40,"female","Venezuela (República Bolivariana de)","Bachillerato",1
"834",10,9,14,12,8,3,5,7,2,1,7,7,6,4,3,5,6,3,73.5370001792908,18,"male","Nicaragua","Bachillerato",7
"836",13,11,14,14,13,14,7,7,7,7,7,7,7,6,7,6,4,7,139.746000051498,24,"female","Venezuela (República Bolivariana de)","Formación comercial/técnica/vocacional",5
"837",14,11,12,10,12,3,3,7,2,1,5,7,7,7,6,6,6,5,65.7339999675751,25,"female","Honduras","Licenciatura",3
"839",14,14,14,13,14,11,6,7,4,7,7,7,7,7,7,7,7,7,42.9649996757507,19,"female","Nicaragua","Bachillerato",NA
"840",14,9,14,11,14,11,4,7,7,4,7,7,7,7,7,7,4,5,108.752999782562,23,"female","Venezuela (República Bolivariana de)","Licenciatura",2
"841",13,12,13,11,13,3,4,7,2,1,7,6,7,6,6,7,6,6,51.1850001811981,18,"male","Nicaragua","Formación comercial/técnica/vocacional",2
"842",8,6,14,11,10,9,7,4,5,4,7,7,5,3,4,6,3,3,134.683000087738,23,"male","Bolivia (Estado Plurinacional de)","Bachillerato",4
"843",14,13,13,14,12,6,7,7,4,2,6,7,7,7,6,6,7,6,109.529000043869,25,"female","Nicaragua","Bachillerato",2
"844",13,12,13,14,13,12,7,7,6,6,6,7,7,6,6,7,5,7,56.1110000610352,21,"other","Honduras","Bachillerato",7
"847",10,10,13,9,11,7,4,5,3,4,7,6,5,5,4,7,5,5,69.2300000190735,21,"female","Venezuela (República Bolivariana de)","Bachillerato",1
"849",14,12,14,14,14,12,7,7,6,6,7,7,7,7,7,7,6,6,45.460000038147,26,NA,"Bolivia (Estado Plurinacional de)","Bachillerato",1
"850",8,12,14,12,14,2,6,6,1,1,7,7,6,2,7,7,6,6,65.4079999923706,20,"male","Bolivia (Estado Plurinacional de)","Bachillerato",4
"851",13,11,13,14,10,5,7,7,1,4,6,7,7,6,5,5,6,5,46.0569999217987,24,"female","Colombia","Bachillerato",2
"852",14,14,14,14,14,2,7,7,1,1,7,7,7,7,7,7,7,7,45.5500001907349,20,"male","Venezuela (República Bolivariana de)","Bachillerato",1
"853",13,11,13,14,12,10,7,7,6,4,7,6,6,7,6,6,4,7,111.586999893188,25,"female","Venezuela (República Bolivariana de)","Licenciatura",1
"854",13,13,14,13,14,14,6,7,7,7,7,7,7,6,7,7,7,6,90.8040001392365,25,"male","Bolivia (Estado Plurinacional de)","Bachillerato",3
"855",10,9,13,13,7,4,6,7,1,3,6,7,5,5,3,4,5,4,82.8259997367859,19,"female","Venezuela (República Bolivariana de)","Bachillerato",1
"857",11,8,12,10,14,10,5,5,3,7,5,7,7,4,7,7,4,4,61.0069999694824,20,"female","Venezuela (República Bolivariana de)","Bachillerato",2
"859",14,12,14,14,11,6,7,7,4,2,7,7,7,7,4,7,5,7,45.6690001487732,21,"male","Venezuela (República Bolivariana de)","Bachillerato",7
"860",14,12,12,12,12,3,5,7,1,2,6,6,7,7,6,6,6,6,47.7249999046326,25,NA,"Bolivia (Estado Plurinacional de)","Licenciatura",2
"861",14,14,13,14,8,2,7,7,1,1,6,7,7,7,4,4,7,7,36.4570000171661,20,"female","Nicaragua","Licenciatura",1
"862",12,13,12,12,12,7,6,6,5,2,6,6,6,6,6,6,7,6,117.723999977112,20,"female","Venezuela (República Bolivariana de)","Formación comercial/técnica/vocacional",1
"864",12,14,14,13,11,3,6,7,1,2,7,7,5,7,7,4,7,7,88.8409998416901,18,"female","Venezuela (República Bolivariana de)","Bachillerato",1
"865",14,12,14,13,12,4,6,7,2,2,7,7,7,7,6,6,6,6,121.15700006485,33,"male","Venezuela (República Bolivariana de)","Licenciatura",1
"867",14,14,10,11,14,2,4,7,1,1,6,4,7,7,7,7,7,7,72.4990000724792,31,NA,"Venezuela (República Bolivariana de)","Grado profesional",1
"868",14,14,14,14,14,6,7,7,3,3,7,7,7,7,7,7,7,7,59.8059997558594,27,"female","Venezuela (República Bolivariana de)","Bachillerato",1
"869",14,14,14,14,11,11,7,7,7,4,7,7,7,7,7,4,7,7,47.1630001068115,31,"female","Venezuela (República Bolivariana de)","Formación comercial/técnica/vocacional",1
"870",14,12,14,14,9,3,7,7,2,1,7,7,7,7,5,4,6,6,43.9719998836517,24,"female","Venezuela (República Bolivariana de)","Formación comercial/técnica/vocacional",1
"871",11,7,14,8,8,8,4,4,4,4,7,7,4,7,4,4,4,3,33.9950001239777,22,"male","Belice","Licenciatura",2
"874",6,2,14,14,10,8,7,7,4,4,7,7,3,3,3,7,1,1,42.6899998188019,18,"female","Nicaragua","Bachillerato",1
"875",13,12,14,11,11,14,4,7,7,7,7,7,7,6,6,5,7,5,36.9050002098083,24,"female","Nicaragua","Bachillerato",1
"876",11,7,11,10,13,10,3,7,6,4,6,5,6,5,6,7,3,4,98.0309998989105,21,"female","Honduras","Maestría",1
"877",12,12,14,14,14,10,7,7,7,3,7,7,7,5,7,7,7,5,78.0290002822876,24,"male","Colombia","Formación comercial/técnica/vocacional",2
"878",9,10,12,13,14,11,6,7,5,6,6,6,5,4,7,7,6,4,57.0559997558594,19,NA,"","",NA
"879",12,14,14,14,10,3,7,7,1,2,7,7,7,5,5,5,7,7,51.7119998931885,23,"female","Nicaragua","Grado profesional",1
"881",14,14,14,14,14,8,7,7,4,4,7,7,7,7,7,7,7,7,54.5440001487732,24,"male","Bolivia (Estado Plurinacional de)","Licenciatura",2
"882",9,9,12,11,14,8,4,7,4,4,6,6,4,5,7,7,5,4,45.595999956131,NA,NA,"","",NA
"883",14,14,14,14,14,2,7,7,1,1,7,7,7,7,7,7,7,7,90.1369998455048,19,"male","Venezuela (República Bolivariana de)","Bachillerato",3
"888",14,8,10,11,14,7,5,6,3,4,6,4,7,7,7,7,4,4,37.672000169754,22,"female","Venezuela (República Bolivariana de)","Bachillerato",7
"891",13,7,14,10,10,2,3,7,1,1,7,7,7,6,3,7,3,4,119.515999794006,20,"female","Venezuela (República Bolivariana de)","Bachillerato",NA
"892",13,10,14,14,11,7,7,7,5,2,7,7,7,6,4,7,6,4,68.6029999256134,26,"male","Bolivia (Estado Plurinacional de)","Licenciatura",1
"893",14,14,14,14,14,2,7,7,1,1,7,7,7,7,7,7,7,7,43.1639997959137,36,NA,"Venezuela (República Bolivariana de)","Grado profesional",3
"894",13,13,14,10,13,10,6,4,4,6,7,7,7,6,6,7,7,6,64.9670000076294,18,"female","Bolivia (Estado Plurinacional de)","Bachillerato",1
"897",14,14,14,14,14,2,7,7,1,1,7,7,7,7,7,7,7,7,74.8659999370575,24,"male","Venezuela (República Bolivariana de)","Bachillerato",1
"899",11,5,12,12,10,7,5,7,4,3,6,6,6,5,4,6,3,2,49.3269999027252,NA,NA,"","",NA
"900",14,14,12,12,10,7,6,6,3,4,5,7,7,7,5,5,7,7,53.989000082016,25,"female","Nicaragua","Licenciatura",1
"901",12,14,10,8,11,7,5,3,2,5,6,4,6,6,6,5,7,7,65.914999961853,77,NA,"Argentina","",NA
"902",12,11,14,14,9,12,7,7,5,7,7,7,7,5,3,6,6,5,70.5199999809265,18,"female","","",NA
"903",14,14,11,14,11,2,7,7,1,1,4,7,7,7,7,4,7,7,50.7039999961853,18,"male","","Formación comercial/técnica/vocacional",2
"904",11,9,14,13,14,13,6,7,7,6,7,7,6,5,7,7,4,5,91.4740002155304,37,"female","Venezuela (República Bolivariana de)","Formación comercial/técnica/vocacional",1
"905",13,12,14,13,13,12,6,7,6,6,7,7,6,7,7,6,6,6,72.4919998645782,NA,"male","Argentina","Bachillerato",3
"907",10,12,14,11,11,10,7,4,7,3,7,7,6,4,4,7,5,7,108.660000324249,24,"female","Bolivia (Estado Plurinacional de)","Bachillerato",1
"908",13,10,14,14,12,7,7,7,3,4,7,7,7,6,5,7,4,6,53.5329999923706,22,"female","Bolivia (Estado Plurinacional de)","Formación comercial/técnica/vocacional",NA
"910",13,13,14,13,13,7,7,6,6,1,7,7,6,7,6,7,7,6,104.549999952316,34,"female","Venezuela (República Bolivariana de)","Licenciatura",1
"915",10,9,11,14,13,2,7,7,1,1,4,7,6,4,6,7,5,4,48.8610000610352,23,"male","Venezuela (República Bolivariana de)","Bachillerato",1
"916",14,14,14,14,14,2,7,7,1,1,7,7,7,7,7,7,7,7,117.391999959946,23,"male","Venezuela (República Bolivariana de)","Bachillerato",1
"923",13,12,14,14,14,13,7,7,6,7,7,7,7,6,7,7,7,5,47.2269997596741,18,NA,"Venezuela (República Bolivariana de)","Bachillerato",7
"926",14,12,14,14,13,8,7,7,5,3,7,7,7,7,6,7,6,6,37.9089999198914,28,"male","Venezuela (República Bolivariana de)","Formación comercial/técnica/vocacional",7
"927",12,6,14,14,14,14,7,7,7,7,7,7,7,5,7,7,5,1,55.797000169754,21,"male","Nicaragua","Bachillerato",1
"929",14,14,14,14,14,11,7,7,5,6,7,7,7,7,7,7,7,7,49.3120002746582,26,"male","Bolivia (Estado Plurinacional de)","Bachillerato",3
"933",13,10,12,13,10,9,6,7,4,5,6,6,6,7,4,6,5,5,59.7649998664856,42,"male","Venezuela (República Bolivariana de)","Bachillerato",3
"934",14,14,14,14,14,10,7,7,5,5,7,7,7,7,7,7,7,7,41.4920001029968,20,"male","Ecuador","Bachillerato",7
"935",13,9,14,14,12,14,7,7,7,7,7,7,7,6,5,7,4,5,61.2089998722076,19,NA,"Venezuela (República Bolivariana de)","Formación comercial/técnica/vocacional",4
"936",12,6,14,13,14,11,6,7,7,4,7,7,6,6,7,7,3,3,47.8150000572205,23,"female","Guatemala","Formación comercial/técnica/vocacional",1
"939",4,2,5,10,10,13,7,3,6,7,4,1,2,2,5,5,1,1,52.5949997901917,20,"male","","Licenciatura",4
"940",3,4,8,11,10,12,7,4,6,6,4,4,1,2,5,5,2,2,50.0469999313354,NA,NA,"","",NA
"941",3,2,8,14,10,12,7,7,6,6,4,4,1,2,5,5,1,1,37.1629998683929,24,"male","Argentina","Bachillerato",5
"942",5,5,8,14,10,12,7,7,6,6,4,4,4,1,5,5,1,4,41.2330000400543,NA,NA,"","",NA
"943",2,2,8,10,14,12,5,5,6,6,4,4,1,1,7,7,1,1,32.9270000457764,20,"male","","",NA
"944",14,12,14,14,14,14,7,7,7,7,7,7,7,7,7,7,6,6,31.6410000324249,29,NA,"Nicaragua","",6
"946",14,13,13,14,11,4,7,7,1,3,7,6,7,7,4,7,6,7,67.8200001716614,28,"male","Colombia","Licenciatura",4
"947",2,2,8,14,10,4,7,7,2,2,4,4,1,1,5,5,1,1,30.5599999427795,NA,NA,"","",NA
"949",10,9,13,12,13,2,5,7,1,1,6,7,4,6,7,6,5,4,51.0369999408722,38,NA,"Venezuela (República Bolivariana de)","Licenciatura",7
"951",12,14,14,14,14,12,7,7,6,6,7,7,6,6,7,7,7,7,54.2230000495911,23,"male","Bolivia (Estado Plurinacional de)","Licenciatura",6
"952",13,10,11,12,7,11,5,7,6,5,5,6,7,6,4,3,6,4,46.9270000457764,20,"female","Colombia","Bachillerato",2
"953",11,12,14,11,14,6,7,4,1,5,7,7,7,4,7,7,7,5,79.789999961853,18,NA,"Venezuela (República Bolivariana de)","Licenciatura",1
"956",14,13,14,13,14,14,6,7,7,7,7,7,7,7,7,7,7,6,42.8970000743866,37,"female","Venezuela (República Bolivariana de)","Bachillerato",1
"960",14,14,14,13,13,14,6,7,7,7,7,7,7,7,6,7,7,7,87.4720001220703,23,NA,"Bolivia (Estado Plurinacional de)","Bachillerato",2
"961",11,13,13,10,12,8,4,6,4,4,6,7,5,6,6,6,6,7,37.0650000572205,24,"female","Bolivia (Estado Plurinacional de)","Formación comercial/técnica/vocacional",NA
"963",12,9,10,12,12,10,6,6,5,5,3,7,6,6,6,6,3,6,40.6240000724792,20,"male","Australia","Bachillerato",2
"964",13,12,12,11,12,12,5,6,6,6,6,6,6,7,6,6,6,6,65.1920001506805,26,"male","Guatemala","Bachillerato",2
"971",14,14,6,14,4,4,7,7,2,2,4,2,7,7,2,2,7,7,57.1480000019073,23,"male","Bolivia (Estado Plurinacional de)","Licenciatura",2
"977",13,11,13,13,13,6,6,7,2,4,6,7,7,6,6,7,6,5,60.2569999694824,25,"male","","",NA
"979",10,6,12,13,11,4,6,7,1,3,6,6,6,4,6,5,3,3,44.529000043869,22,NA,"Honduras","Doctorado",4
"982",9,12,14,14,13,7,7,7,1,6,7,7,5,4,7,6,6,6,55.1700000762939,21,"male","El Salvador","Licenciatura",7
"986",10,9,11,12,14,12,5,7,7,5,7,4,5,5,7,7,4,5,77.327999830246,24,"male","Colombia","Bachillerato",7
"988",14,9,14,14,14,2,7,7,1,1,7,7,7,7,7,7,5,4,127.674999952316,26,"female","El Salvador","Licenciatura",1
"989",10,11,11,10,10,9,5,5,4,5,5,6,5,5,5,5,6,5,113.118999958038,18,"female","Bolivia (Estado Plurinacional de)","Bachillerato",2
"990",13,11,12,14,13,8,7,7,5,3,7,5,7,6,6,7,6,5,49.4229998588562,23,"male","Bolivia (Estado Plurinacional de)","Licenciatura",4
"992",12,13,14,13,14,13,6,7,6,7,7,7,6,6,7,7,6,7,77.5680000782013,23,"male","Bolivia (Estado Plurinacional de)","Bachillerato",5
"996",14,14,14,14,14,2,7,7,1,1,7,7,7,7,7,7,7,7,41.3310000896454,24,"male","Bolivia (Estado Plurinacional de)","Formación comercial/técnica/vocacional",3
"997",14,13,14,14,9,5,7,7,4,1,7,7,7,7,5,4,6,7,111.739000082016,NA,NA,"","",NA
"998",14,14,14,14,14,2,7,7,1,1,7,7,7,7,7,7,7,7,75.3720002174377,52,"male","Bolivia (Estado Plurinacional de)","Bachillerato",NA
"999",13,14,14,14,14,11,7,7,5,6,7,7,7,6,7,7,7,7,75.7670001983643,20,"female","Bolivia (Estado Plurinacional de)","Licenciatura",3
"1000",14,14,14,14,14,12,7,7,7,5,7,7,7,7,7,7,7,7,115.40700006485,25,"male","Bolivia (Estado Plurinacional de)","Licenciatura",5
"1002",13,8,12,9,14,7,5,4,3,4,7,5,6,7,7,7,3,5,61.691999912262,25,"male","Bolivia (Estado Plurinacional de)","Bachillerato",4
"1006",10,9,13,12,10,6,6,6,3,3,6,7,5,5,4,6,5,4,106.124000072479,23,"female","Honduras","Licenciatura",2
"1007",10,9,14,11,11,8,5,6,4,4,7,7,5,5,4,7,5,4,36.0830001831055,NA,NA,"","",NA
"1011",9,9,14,14,8,4,7,7,2,2,7,7,7,2,2,6,2,7,70.6750001907349,28,NA,"Nicaragua","Bachillerato",1
"1012",14,14,14,14,14,12,7,7,7,5,7,7,7,7,7,7,7,7,47.4249999523163,34,"female","Venezuela (República Bolivariana de)","Grado profesional",7
"1014",11,12,13,11,11,11,4,7,5,6,7,6,7,4,4,7,7,5,91.7230000495911,22,"male","Bolivia (Estado Plurinacional de)","Bachillerato",NA
"1017",13,14,14,13,11,10,6,7,5,5,7,7,7,6,5,6,7,7,72.1459999084473,30,"female","Venezuela (República Bolivariana de)","Grado profesional",2
"1022",14,12,14,14,13,2,7,7,1,1,7,7,7,7,6,7,5,7,73.6989998817444,18,"female","Venezuela (República Bolivariana de)","Licenciatura",2
"1026",14,12,14,14,11,13,7,7,6,7,7,7,7,7,7,4,5,7,90.103000164032,30,"male","Bolivia (Estado Plurinacional de)","Formación comercial/técnica/vocacional",1
"1027",14,14,14,14,14,6,7,7,1,5,7,7,7,7,7,7,7,7,43.9349999427795,39,NA,"Venezuela (República Bolivariana de)","Licenciatura",7
"1029",14,14,13,14,14,10,7,7,6,4,6,7,7,7,7,7,7,7,45.0909998416901,19,"female","Bolivia (Estado Plurinacional de)","Formación comercial/técnica/vocacional",5
"1031",14,11,11,11,12,9,4,7,5,4,4,7,7,7,6,6,6,5,47.4979999065399,24,"male","Bolivia (Estado Plurinacional de)","Grado profesional",7
"1032",13,11,12,9,9,11,3,6,6,5,6,6,7,6,4,5,5,6,51.7430000305176,65,"female","Venezuela (República Bolivariana de)","Bachillerato",7
"1033",11,10,14,14,14,13,7,7,6,7,7,7,6,5,7,7,5,5,60.5130000114441,20,"male","Bolivia (Estado Plurinacional de)","Bachillerato",1
"1038",8,8,14,13,14,14,6,7,7,7,7,7,4,4,7,7,4,4,63.1039998531342,23,"male","Bolivia (Estado Plurinacional de)","Bachillerato",1
"1039",12,12,12,12,12,10,6,6,5,5,6,6,6,6,7,5,6,6,31.9370002746582,27,"male","Bolivia (Estado Plurinacional de)","Licenciatura",7
"1042",12,8,13,14,11,9,7,7,5,4,6,7,5,7,7,4,4,4,51.8630001544952,49,"male","Venezuela (República Bolivariana de)","Bachillerato",3
"1043",14,14,13,12,12,14,5,7,7,7,7,6,7,7,5,7,7,7,71.8020000457764,NA,"male","Venezuela (República Bolivariana de)","Bachillerato",3
"1045",12,14,7,13,13,4,6,7,2,2,2,5,6,6,6,7,7,7,76.3280000686646,19,"male","Nicaragua","Formación comercial/técnica/vocacional",4
"1046",14,14,14,14,12,11,7,7,5,6,7,7,7,7,7,5,7,7,51.6629998683929,34,"female","Venezuela (República Bolivariana de)","Licenciatura",1
"1047",9,11,14,14,14,6,7,7,2,4,7,7,5,4,7,7,5,6,78.8120000362396,26,"male","Argentina","Licenciatura",7
"1048",3,6,2,2,4,4,1,1,3,1,1,1,1,2,2,2,3,3,58.896999835968,25,"male","Bolivia (Estado Plurinacional de)","Licenciatura",1
"1051",14,13,13,12,14,13,5,7,6,7,7,6,7,7,7,7,7,6,85.6000001430511,23,"male","Bolivia (Estado Plurinacional de)","Licenciatura",5
"1052",14,8,14,14,10,8,7,7,4,4,7,7,7,7,6,4,4,4,87.2519998550415,54,"female","","Licenciatura",1
"1053",11,14,14,12,12,12,6,6,7,5,7,7,5,6,7,5,7,7,88.0209999084473,20,"female","Bolivia (Estado Plurinacional de)","Licenciatura",1
"1054",11,5,14,9,14,13,5,4,7,6,7,7,6,5,7,7,3,2,121.221999883652,23,"male","Bolivia (Estado Plurinacional de)","Licenciatura",7
"1055",14,13,14,14,14,11,7,7,5,6,7,7,7,7,7,7,7,6,56.0120000839233,42,"female","Nicaragua","Formación comercial/técnica/vocacional",1
"1056",14,12,13,12,13,10,5,7,5,5,7,6,7,7,6,7,6,6,65.5389997959137,24,"male","Bolivia (Estado Plurinacional de)","Licenciatura",3
"1059",13,13,14,13,14,10,6,7,5,5,7,7,7,6,7,7,7,6,55.5429999828339,34,NA,"Colombia","Licenciatura",1
"1060",11,5,12,13,11,10,6,7,4,6,7,5,7,4,4,7,1,4,31.2079999446869,22,NA,"Uruguay","Bachillerato",3
"1061",14,11,14,14,14,14,7,7,7,7,7,7,7,7,7,7,7,4,35.8390002250671,28,"male","Colombia","Bachillerato",2
"1062",10,7,14,13,12,4,7,6,1,3,7,7,6,4,6,6,3,4,61.1409997940063,25,"female","Bolivia (Estado Plurinacional de)","Licenciatura",1
"1065",14,13,14,13,14,9,6,7,7,2,7,7,7,7,7,7,7,6,65.7469999790192,28,"female","Venezuela (República Bolivariana de)","Bachillerato",1
"1067",14,14,13,14,14,11,7,7,7,4,7,6,7,7,7,7,7,7,33.1920001506805,23,"male","","Formación comercial/técnica/vocacional",3
"1069",14,6,14,14,14,11,7,7,7,4,7,7,7,7,7,7,3,3,57.2630000114441,34,"male","Venezuela (República Bolivariana de)","Bachillerato",1
"1071",12,10,14,11,8,7,4,7,3,4,7,7,5,7,4,4,5,5,73.8990001678467,33,"female","Venezuela (República Bolivariana de)","Grado de asociado",NA
"1073",12,12,7,12,12,10,6,6,3,7,4,3,6,6,6,6,6,6,39.061999797821,49,"male","Venezuela (República Bolivariana de)","Licenciatura",7
"1074",13,13,14,14,13,11,7,7,5,6,7,7,6,7,6,7,7,6,55.6529998779297,31,"male","Venezuela (República Bolivariana de)","Licenciatura",5
"1075",14,13,14,14,14,11,7,7,5,6,7,7,7,7,7,7,6,7,46.7119998931885,20,"female","Venezuela (República Bolivariana de)","Bachillerato",1
"1076",10,9,10,8,10,8,4,4,3,5,5,5,5,5,5,5,4,5,82.8970000743866,41,"female","Venezuela (República Bolivariana de)","Grado profesional",1
"1077",11,11,14,14,13,6,7,7,1,5,7,7,7,4,6,7,5,6,53.3069999217987,26,"female","Venezuela (República Bolivariana de)","Bachillerato",1
"1078",14,10,14,14,14,6,7,7,4,2,7,7,7,7,7,7,5,5,37.9229998588562,20,"female","Venezuela (República Bolivariana de)","Bachillerato",1
"1079",2,2,4,14,10,12,7,7,6,6,2,2,1,1,5,5,1,1,51.7519998550415,32,"male","Estados Unidos de América","Licenciatura",5
"1081",12,10,10,11,12,9,5,6,4,5,5,5,6,6,6,6,5,5,56.0900001525879,27,"female","Venezuela (República Bolivariana de)","Bachillerato",4
"1082",11,8,10,12,11,9,5,7,3,6,5,5,5,6,5,6,5,3,71.7560000419617,NA,NA,"","",NA
"1083",13,11,14,12,11,4,6,6,2,2,7,7,7,6,4,7,6,5,52.6490001678467,26,"male","Venezuela (República Bolivariana de)","Grado profesional",5
"1084",14,14,14,14,14,2,7,7,1,1,7,7,7,7,7,7,7,7,48.423999786377,33,"male","Venezuela (República Bolivariana de)","Bachillerato",2
"1085",12,9,12,12,14,8,5,7,5,3,7,5,6,6,7,7,4,5,108.973000049591,27,"female","Bolivia (Estado Plurinacional de)","Licenciatura",3
"1086",11,8,8,11,11,8,7,4,4,4,4,4,4,7,7,4,4,4,96.4350001811981,65,"female","Venezuela (República Bolivariana de)","Grado profesional",NA
"1088",14,6,12,13,12,12,6,7,5,7,6,6,7,7,6,6,3,3,110.139999866486,25,"female","Venezuela (República Bolivariana de)","Formación comercial/técnica/vocacional",3
"1093",14,14,14,14,14,5,7,7,3,2,7,7,7,7,7,7,7,7,87.8959999084473,45,"female","Colombia","Bachillerato",6
"1094",12,14,14,12,8,4,5,7,3,1,7,7,7,5,4,4,7,7,50.260999917984,23,"female","Venezuela (República Bolivariana de)","Licenciatura",NA
"1095",13,14,14,14,14,10,7,7,7,3,7,7,7,6,7,7,7,7,46.2659997940063,44,"female","Venezuela (República Bolivariana de)","Maestría",1
"1097",12,12,9,13,13,7,7,6,3,4,4,5,7,5,6,7,7,5,67.7910001277924,26,"male","Bolivia (Estado Plurinacional de)","Licenciatura",1
"1100",14,14,14,14,14,2,7,7,1,1,7,7,7,7,7,7,7,7,141.578999996185,26,"female","Bolivia (Estado Plurinacional de)","Licenciatura",1
"1101",10,10,13,13,10,10,7,6,4,6,7,6,6,4,4,6,6,4,72.3050003051758,54,"male","El Salvador","Grado profesional",2
"1104",10,10,8,9,7,6,5,4,3,3,4,4,6,4,3,4,4,6,51.0710000991821,20,"male","Bolivia (Estado Plurinacional de)","Licenciatura",1
"1107",11,10,12,13,13,13,6,7,7,6,6,6,7,4,7,6,6,4,54.0389997959137,37,"male","Bolivia (Estado Plurinacional de)","Formación comercial/técnica/vocacional",1
"1108",11,8,14,10,10,9,4,6,5,4,7,7,6,5,4,6,4,4,48.8639998435974,NA,"female","Bolivia (Estado Plurinacional de)","Formación comercial/técnica/vocacional",3
"1109",12,12,11,13,12,10,6,7,5,5,7,4,6,6,6,6,6,6,59.5909998416901,20,"male","Bolivia (Estado Plurinacional de)","Grado profesional",7
"1111",6,2,14,13,14,7,6,7,6,1,7,7,5,1,7,7,1,1,71.5940001010895,19,"female","Nicaragua","Bachillerato",1
"1113",12,8,10,14,14,8,7,7,6,2,5,5,6,6,7,7,7,1,55.1939997673035,36,"male","Argentina","Bachillerato",1
"1118",12,13,14,14,13,5,7,7,4,1,7,7,6,6,6,7,7,6,51.1569998264313,22,"male","Bolivia (Estado Plurinacional de)","Licenciatura",NA
"1119",13,12,10,14,10,13,7,7,7,6,7,3,7,6,4,6,6,6,49.7929999828339,21,"female","Argentina","Bachillerato",6
"1122",14,14,14,14,14,5,7,7,4,1,7,7,7,7,7,7,7,7,80.8999998569489,40,"male","Bolivia (Estado Plurinacional de)","Grado profesional",7
"1123",13,12,14,14,14,7,7,7,6,1,7,7,7,6,7,7,7,5,81.7590000629425,29,"male","Venezuela (República Bolivariana de)","Bachillerato",7
"1124",14,5,14,11,10,9,5,6,2,7,7,7,7,7,3,7,2,3,100.598999977112,44,"female","Venezuela (República Bolivariana de)","Bachillerato",2
"1127",14,9,14,13,12,12,6,7,6,6,7,7,7,7,6,6,5,4,105.164999961853,35,"female","Argentina","Bachillerato",1
"1129",13,14,14,14,11,11,7,7,6,5,7,7,6,7,7,4,7,7,40.8300001621246,NA,NA,"","",NA
"1131",12,6,8,10,10,7,4,6,5,2,4,4,6,6,4,6,4,2,44.1479997634888,28,"male","Bolivia (Estado Plurinacional de)","Bachillerato",7
"1132",14,14,14,13,14,2,6,7,1,1,7,7,7,7,7,7,7,7,47.5899999141693,22,"female","Argentina","Formación comercial/técnica/vocacional",3
"1134",12,13,12,14,13,10,7,7,5,5,5,7,6,6,6,7,7,6,48.8200001716614,51,"female","Venezuela (República Bolivariana de)","Licenciatura",1
"1136",14,11,14,13,10,8,6,7,4,4,7,7,7,7,5,5,6,5,37.2799999713898,NA,NA,"","",NA
"1139",13,10,13,10,14,6,6,4,4,2,7,6,7,6,7,7,5,5,63.4270000457764,19,"female","Argentina","Bachillerato",1
"1140",12,12,12,12,13,5,6,6,2,3,6,6,6,6,7,6,6,6,34.7210001945496,25,"male","Bolivia (Estado Plurinacional de)","Licenciatura",1
"1141",14,14,14,14,14,10,7,7,6,4,7,7,7,7,7,7,7,7,56.8210000991821,23,"male","Venezuela (República Bolivariana de)","Bachillerato",7
"1142",14,12,14,14,14,8,7,7,4,4,7,7,7,7,7,7,6,6,57.3199999332428,NA,NA,"","",NA
"1146",13,14,14,14,14,13,7,7,6,7,7,7,7,6,7,7,7,7,47.5310001373291,30,"female","El Salvador","Bachillerato",1
"1149",13,5,14,13,12,11,6,7,4,7,7,7,7,6,7,5,2,3,67.7630000114441,44,NA,"Argentina","Grado profesional",2
"1151",8,6,13,14,12,11,7,7,4,7,7,6,4,4,6,6,2,4,131.968000173569,37,"male","Venezuela (República Bolivariana de)","Formación comercial/técnica/vocacional",NA
"1155",11,11,14,14,14,13,7,7,6,7,7,7,6,5,7,7,6,5,85.7360000610352,19,"female","Nicaragua","Formación comercial/técnica/vocacional",5
"1157",14,14,12,11,14,2,4,7,1,1,5,7,7,7,7,7,7,7,52.4090001583099,36,"male","Argentina","",7
"1161",11,13,14,14,14,4,7,7,3,1,7,7,6,5,7,7,7,6,58.8980002403259,19,"female","Bolivia (Estado Plurinacional de)","Grado profesional",1
"1163",11,11,14,13,11,2,6,7,1,1,7,7,7,4,4,7,4,7,79.4049999713898,29,"male","Argentina","Bachillerato",5
"1164",14,14,14,14,14,2,7,7,1,1,7,7,7,7,7,7,7,7,44.7049999237061,38,"male","Argentina","Bachillerato",1
"1165",9,8,14,14,14,8,7,7,4,4,7,7,5,4,7,7,4,4,56.444000005722,30,"male","","Formación comercial/técnica/vocacional",4
"1167",14,9,14,13,10,14,6,7,7,7,7,7,7,7,5,5,4,5,62.1729998588562,41,NA,"Venezuela (República Bolivariana de)","Grado profesional",1
"1168",12,10,11,11,10,2,5,6,1,1,6,5,6,6,5,5,5,5,51.5320000648499,68,"male","Venezuela (República Bolivariana de)","Licenciatura",3
"1169",14,11,14,14,14,9,7,7,4,5,7,7,7,7,7,7,5,6,53.2369999885559,39,"female","Venezuela (República Bolivariana de)","Bachillerato",4
"1173",14,13,14,13,13,13,7,6,7,6,7,7,7,7,6,7,7,6,44.4370000362396,30,"male","Nicaragua","Bachillerato",NA
"1179",14,14,14,14,14,12,7,7,5,7,7,7,7,7,7,7,7,7,78.0629999637604,26,"male","Bolivia (Estado Plurinacional de)","Bachillerato",1
"1180",11,14,14,14,14,11,7,7,4,7,7,7,7,4,7,7,7,7,58.3339998722076,37,"male","Perú","Formación comercial/técnica/vocacional",2
"1182",11,14,10,11,13,10,6,5,4,6,6,4,7,4,7,6,7,7,56.2930002212524,31,"male","Argentina","Grado de asociado",3
"1184",14,14,14,14,11,13,7,7,6,7,7,7,7,7,4,7,7,7,58.9719998836517,NA,NA,"","",NA
"1185",13,9,13,14,12,12,7,7,7,5,7,6,7,6,5,7,7,2,60.1870000362396,47,"male","Argentina","Grado profesional",7
"1187",8,8,14,14,13,2,7,7,1,1,7,7,7,1,6,7,7,1,123.782999992371,42,"female","Venezuela (República Bolivariana de)","Licenciatura",1
"1188",13,12,12,14,14,6,7,7,5,1,6,6,7,6,7,7,6,6,44.7419998645782,38,NA,"Venezuela (República Bolivariana de)","Licenciatura",4
"1189",12,10,12,13,14,8,6,7,4,4,6,6,7,5,7,7,5,5,41.8839998245239,24,NA,"Colombia","Formación comercial/técnica/vocacional",1
"1191",14,6,14,14,9,12,7,7,7,5,7,7,7,7,7,2,3,3,60.3719997406006,51,"female","Colombia","Bachillerato",1
"1192",14,12,14,13,11,5,6,7,4,1,7,7,7,7,6,5,7,5,79.8230001926422,20,"female","Honduras","",1
"1193",8,5,14,13,12,11,6,7,7,4,7,7,4,4,5,7,1,4,71.6640000343323,21,"male","Bolivia (Estado Plurinacional de)","Bachillerato",7
"1196",12,12,14,14,12,5,7,7,4,1,7,7,6,6,5,7,6,6,107.891999959946,44,"female","Colombia","Grado profesional",1
"1197",14,8,14,14,14,14,7,7,7,7,7,7,7,7,7,7,7,1,60.3689999580383,48,"male","","Bachillerato",NA
"1198",14,14,12,11,11,2,7,4,1,1,5,7,7,7,7,4,7,7,67.5069999694824,27,"male","El Salvador","Bachillerato",1
"1199",14,6,13,11,9,13,4,7,7,6,6,7,7,7,4,5,3,3,135.209000110626,38,"female","Venezuela (República Bolivariana de)","Licenciatura",1
"1200",12,10,11,12,10,8,6,6,5,3,5,6,6,6,6,4,5,5,60.4899997711182,79,"male","Argentina","Maestría",NA
"1202",11,14,14,13,14,11,6,7,6,5,7,7,7,4,7,7,7,7,63.8180003166199,NA,"female","Argentina","Bachillerato",7
"1203",13,12,14,12,11,4,5,7,2,2,7,7,7,6,4,7,6,6,63.5050001144409,18,"female","Colombia","Bachillerato",NA
"1205",12,11,10,13,12,9,6,7,3,6,5,5,6,6,6,6,6,5,37.2339997291565,18,"female","Colombia","Bachillerato",3
"1206",12,14,12,10,14,11,5,5,6,5,7,5,7,5,7,7,7,7,65.7999999523163,NA,NA,"","",NA
"1207",14,14,14,13,14,7,7,6,1,6,7,7,7,7,7,7,7,7,40.4420001506805,22,NA,"Venezuela (República Bolivariana de)","Bachillerato",5
"1208",12,14,14,14,14,14,7,7,7,7,7,7,7,5,7,7,7,7,99.0870001316071,29,"female","Venezuela (República Bolivariana de)","Licenciatura",1
"1210",13,10,14,14,13,10,7,7,5,5,7,7,7,6,7,6,5,5,75.6399998664856,36,"female","Venezuela (República Bolivariana de)","Licenciatura",4
"1212",11,9,14,14,14,7,7,7,4,3,7,7,7,4,7,7,5,4,54.4720001220703,34,"female","Nicaragua","Licenciatura",1
"1215",5,5,8,14,11,2,7,7,1,1,4,4,3,2,6,5,2,3,47.6020002365112,NA,NA,"","",NA
"1216",7,4,7,14,10,2,7,7,1,1,4,3,4,3,5,5,2,2,35.1360001564026,NA,NA,"","",NA
"1217",6,6,8,12,14,2,6,6,1,1,4,4,3,3,7,7,3,3,32.1440000534058,NA,NA,"","",NA
"1222",14,14,14,14,11,5,7,7,1,4,7,7,7,7,7,4,7,7,54.2350001335144,NA,NA,"","",NA
"1223",11,8,14,14,12,11,7,7,5,6,7,7,6,5,5,7,4,4,74.9059998989105,25,"male","Venezuela (República Bolivariana de)","Grado profesional",6
"1225",10,9,11,10,7,14,6,4,7,7,4,7,6,4,6,1,2,7,63.816999912262,NA,NA,"","",NA
"1231",10,2,13,11,12,10,4,7,4,6,7,6,4,6,5,7,1,1,59.5979998111725,34,"male","Argentina","Bachillerato",4
"1233",14,14,14,14,14,13,7,7,6,7,7,7,7,7,7,7,7,7,52.7090001106262,40,"male","El Salvador","Formación comercial/técnica/vocacional",6
"1234",12,12,12,12,7,2,6,6,1,1,6,6,6,6,6,1,6,6,46.308000087738,68,"male","Venezuela (República Bolivariana de)","Licenciatura",4
"1236",11,9,12,12,12,9,6,6,5,4,6,6,5,6,6,6,5,4,83.816999912262,26,"female","Bolivia (Estado Plurinacional de)","Formación comercial/técnica/vocacional",7
"1241",14,14,14,14,14,3,7,7,1,2,7,7,7,7,7,7,7,7,44.6139998435974,27,"female","Venezuela (República Bolivariana de)","Formación comercial/técnica/vocacional",1
"1243",11,12,12,13,12,7,7,6,3,4,6,6,5,6,5,7,6,6,68.220999956131,22,"female","Bolivia (Estado Plurinacional de)","Formación comercial/técnica/vocacional",2
"1246",14,14,14,14,14,2,7,7,1,1,7,7,7,7,7,7,7,7,42.9089999198914,31,"female","El Salvador","Bachillerato",1
"1247",14,2,14,14,9,14,7,7,7,7,7,7,7,7,2,7,1,1,55.7140002250671,31,"female","Nicaragua","Licenciatura",2
"1248",13,11,12,11,13,11,5,6,6,5,6,6,7,6,6,7,6,5,59.5079998970032,21,"male","Ecuador","Bachillerato",4
"1249",13,12,14,14,13,2,7,7,1,1,7,7,7,6,6,7,6,6,110.806999921799,27,"female","El Salvador","Licenciatura",1
"1250",14,13,14,14,14,5,7,7,4,1,7,7,7,7,7,7,6,7,75.0750000476837,32,"male","Bolivia (Estado Plurinacional de)","Bachillerato",3
"1251",13,11,13,14,6,2,7,7,1,1,7,6,7,6,4,2,5,6,90.2979998588562,37,"female","El Salvador","Licenciatura",1
"1252",10,11,12,11,12,4,6,5,2,2,6,6,5,5,6,6,6,5,40.3180000782013,NA,NA,"","",NA
"1255",10,6,13,9,13,11,3,6,7,4,6,7,6,4,6,7,1,5,63.7940001487732,32,"male","Bolivia (Estado Plurinacional de)","Bachillerato",1
"1256",13,11,8,13,9,6,6,7,5,1,1,7,6,7,4,5,7,4,92.8359999656677,42,"female","Bolivia (Estado Plurinacional de)","Bachillerato",1
"1257",14,12,14,13,10,9,6,7,5,4,7,7,7,7,6,4,6,6,58.0920000076294,51,"female","Venezuela (República Bolivariana de)","Formación comercial/técnica/vocacional",1
"1263",12,12,12,12,12,8,6,6,5,3,6,6,6,6,6,6,6,6,89.5189998149872,26,"female","Bolivia (Estado Plurinacional de)","Licenciatura",3
"1269",14,10,14,14,6,2,7,7,1,1,7,7,7,7,1,5,5,5,56.5950002670288,27,"male","Nicaragua","Licenciatura",1
"1270",13,8,13,12,12,3,6,6,2,1,6,7,7,6,7,5,4,4,70.0529999732971,38,NA,"Venezuela (República Bolivariana de)","Licenciatura",1
"1273",14,11,13,14,11,7,7,7,5,2,7,6,7,7,5,6,6,5,117.083999872208,19,"male","Venezuela (República Bolivariana de)","Bachillerato",6
"1274",14,11,14,14,7,12,7,7,5,7,7,7,7,7,3,4,4,7,48.0149998664856,30,"male","Venezuela (República Bolivariana de)","Bachillerato",2
"1275",12,8,14,14,13,11,7,7,7,4,7,7,6,6,6,7,4,4,45.5079998970032,41,"female","Guatemala","Formación comercial/técnica/vocacional",1
"1280",14,10,14,14,14,5,7,7,4,1,7,7,7,7,7,7,6,4,57.6110000610352,31,"female","Venezuela (República Bolivariana de)","Licenciatura",7
"1281",13,12,13,14,3,12,7,7,6,6,6,7,7,6,1,2,6,6,85.925999879837,46,"female","Venezuela (República Bolivariana de)","Grado profesional",1
"1282",12,12,11,12,12,6,5,7,5,1,6,5,6,6,6,6,6,6,91.2980000972748,NA,NA,"","",NA
"1283",14,14,14,13,14,8,6,7,3,5,7,7,7,7,7,7,7,7,52.2379999160767,NA,NA,"","",NA
"1284",14,12,12,11,12,9,4,7,4,5,6,6,7,7,6,6,6,6,55.3600001335144,47,"female","Venezuela (República Bolivariana de)","Maestría",4
"1285",8,14,14,14,11,9,7,7,5,4,7,7,4,4,4,7,7,7,105.603999853134,22,"female","Venezuela (República Bolivariana de)","Licenciatura",1
"1288",7,14,14,14,8,8,7,7,4,4,7,7,4,3,4,4,7,7,76.1840000152588,24,"male","Bolivia (Estado Plurinacional de)","Licenciatura",1
"1290",14,14,14,14,14,11,7,7,7,4,7,7,7,7,7,7,7,7,88.0350000858307,39,"female","Venezuela (República Bolivariana de)","Bachillerato",1
"1291",14,14,14,14,14,2,7,7,1,1,7,7,7,7,7,7,7,7,43.1339998245239,NA,NA,"","",NA
"1292",13,14,14,12,14,2,6,6,1,1,7,7,7,6,7,7,7,7,87.5670001506805,20,"male","Venezuela (República Bolivariana de)","Bachillerato",2
"1295",14,14,14,10,9,10,3,7,5,5,7,7,7,7,6,3,7,7,30.3830001354218,19,"female","Colombia","Bachillerato",1
"1296",8,9,10,8,10,8,5,3,3,5,5,5,5,3,6,4,3,6,41.4030001163483,18,"male","Ecuador","Bachillerato",7
"1297",14,14,14,13,14,9,7,6,7,2,7,7,7,7,7,7,7,7,106.948999881744,60,"female","Venezuela (República Bolivariana de)","Licenciatura",1
"1298",13,10,11,13,13,2,6,7,1,1,5,6,7,6,7,6,5,5,73.3800001144409,NA,NA,"","",NA
"1299",6,8,14,14,11,10,7,7,4,6,7,7,5,1,4,7,4,4,58.3170001506805,20,"male","Venezuela (República Bolivariana de)","Bachillerato",1
"1306",14,11,14,14,6,6,7,7,1,5,7,7,7,7,4,2,6,5,88.3480000495911,35,"female","Nicaragua","Bachillerato",3
"1308",13,13,14,14,14,10,7,7,5,5,7,7,7,6,7,7,6,7,119.02399969101,23,"female","Venezuela (República Bolivariana de)","Bachillerato",5
"1311",8,5,9,14,14,14,7,7,7,7,4,5,4,4,7,7,4,1,98.3550000190735,23,"female","Venezuela (República Bolivariana de)","Bachillerato",1
"1314",12,12,12,14,12,2,7,7,1,1,6,6,7,5,6,6,6,6,107.619999885559,34,"female","Venezuela (República Bolivariana de)","Grado profesional",1
"1315",14,13,14,14,14,8,7,7,4,4,7,7,7,7,7,7,7,6,72.4449999332428,30,"male","Colombia","Formación comercial/técnica/vocacional",1
"1316",14,4,14,14,14,7,7,7,1,6,7,7,7,7,7,7,2,2,81.6579999923706,27,"male","Bolivia (Estado Plurinacional de)","Grado profesional",1
"1317",14,11,14,11,10,8,4,7,3,5,7,7,7,7,4,6,5,6,44.3129999637604,23,"female","Venezuela (República Bolivariana de)","Bachillerato",NA
"1318",12,10,12,12,10,10,5,7,7,3,5,7,7,5,5,5,5,5,95.7490000724792,19,"female","El Salvador","Bachillerato",2
"1319",12,12,12,11,13,8,5,6,3,5,7,5,5,7,6,7,6,6,39.8270001411438,19,"female","Nicaragua","Bachillerato",NA
"1320",12,10,11,11,9,7,5,6,4,3,6,5,6,6,4,5,5,5,59.0500001907349,NA,NA,"","",NA
"1322",14,14,13,13,13,11,7,6,7,4,7,6,7,7,6,7,7,7,72.6240000724792,70,"male","Venezuela (República Bolivariana de)","Grado de asociado",4
"1324",14,14,14,14,13,8,7,7,4,4,7,7,7,7,6,7,7,7,47.7799997329712,28,"male","Argentina","Bachillerato",3
"1325",5,11,10,13,14,10,7,6,6,4,5,5,2,3,7,7,6,5,49.9790000915527,28,NA,"El Salvador","Licenciatura",NA
"1326",14,13,14,10,11,9,4,6,5,4,7,7,7,7,6,5,7,6,65.3650000095367,NA,NA,"","",NA
"1327",14,14,14,14,14,11,7,7,4,7,7,7,7,7,7,7,7,7,49.5710000991821,35,"female","Venezuela (República Bolivariana de)","Bachillerato",4
"1328",14,14,10,12,11,8,6,6,5,3,5,5,7,7,6,5,7,7,73.3780000209808,81,"female","","",NA
"1331",14,13,11,10,14,2,3,7,1,1,6,5,7,7,7,7,7,6,111.425999879837,57,"male","República Dominicana","Licenciatura",7
"1332",7,7,14,14,11,14,7,7,7,7,7,7,3,4,5,6,4,3,46.8489999771118,37,"male","Colombia","Formación comercial/técnica/vocacional",1
"1335",14,14,14,14,14,6,7,7,3,3,7,7,7,7,7,7,7,7,75.4089999198914,28,"female","Venezuela (República Bolivariana de)","Grado profesional",1
"1336",11,5,12,12,10,9,6,6,5,4,6,6,5,6,4,6,2,3,55.1800000667572,29,NA,"","",NA
"1337",13,8,14,14,12,14,7,7,7,7,7,7,6,7,5,7,4,4,43.1199998855591,NA,"male","Nicaragua","Formación comercial/técnica/vocacional",5
"1338",12,12,12,13,10,6,6,7,1,5,6,6,6,6,4,6,6,6,74.7039999961853,33,"male","Honduras","Licenciatura",1
"1341",8,8,12,10,8,6,6,4,4,2,6,6,4,4,4,4,6,2,69.8139998912811,22,NA,"Bolivia (Estado Plurinacional de)","Grado de asociado",2
"1343",11,13,14,13,14,3,6,7,1,2,7,7,6,5,7,7,6,7,55.1520001888275,32,"female","Venezuela (República Bolivariana de)","Licenciatura",4
"1345",12,6,14,11,14,9,4,7,5,4,7,7,6,6,7,7,2,4,58.5129997730255,22,"female","Venezuela (República Bolivariana de)","Bachillerato",2
"1346",12,13,14,12,12,9,6,6,2,7,7,7,6,6,6,6,7,6,109.984000205994,NA,"female","","",NA
"1349",14,14,13,14,14,7,7,7,6,1,6,7,7,7,7,7,7,7,56.0199999809265,25,NA,"Venezuela (República Bolivariana de)","Bachillerato",1
"1350",13,14,14,13,14,2,6,7,1,1,7,7,7,6,7,7,7,7,69.1870000362396,30,NA,"Venezuela (República Bolivariana de)","Licenciatura",1
"1354",10,9,14,12,12,5,5,7,3,2,7,7,5,5,6,6,4,5,74.3809998035431,35,"female","Venezuela (República Bolivariana de)","Formación comercial/técnica/vocacional",2
"1355",11,8,14,14,14,8,7,7,4,4,7,7,7,4,7,7,4,4,91.8810000419617,28,"male","Argentina","Bachillerato",7
"1356",12,12,14,14,10,6,7,7,2,4,7,7,7,5,5,5,6,6,62.9570002555847,18,"male","Ecuador","Bachillerato",2
"1358",9,9,14,11,9,11,6,5,4,7,7,7,7,2,4,5,5,4,73.8719997406006,24,"female","Venezuela (República Bolivariana de)","Bachillerato",1
"1359",14,14,14,14,14,5,7,7,4,1,7,7,7,7,7,7,7,7,33.7839999198914,31,"female","Bolivia (Estado Plurinacional de)","Licenciatura",1
"1360",14,14,14,14,14,4,7,7,2,2,7,7,7,7,7,7,7,7,73.1889998912811,35,NA,"Venezuela (República Bolivariana de)","Bachillerato",3
"1364",14,13,14,14,12,7,7,7,3,4,7,7,7,7,5,7,6,7,105.584000110626,33,"female","Venezuela (República Bolivariana de)","Licenciatura",1
"1369",14,14,14,14,14,11,7,7,4,7,7,7,7,7,7,7,7,7,41.2539999485016,30,"female","Ecuador","Bachillerato",1
"1370",14,8,11,11,14,10,4,7,3,7,7,4,7,7,7,7,4,4,49.6180000305176,36,"female","Venezuela (República Bolivariana de)","",1
"1371",14,14,13,12,14,6,6,6,3,3,7,6,7,7,7,7,7,7,47.5770001411438,27,"female","El Salvador","Bachillerato",1
"1372",14,8,14,12,9,5,6,6,2,3,7,7,7,7,5,4,5,3,72.8129999637604,30,"female","Colombia","Bachillerato",2
"1373",12,11,14,13,11,4,6,7,2,2,7,7,6,6,5,6,6,5,111.841000080109,NA,NA,"","",NA
"1374",14,12,14,12,10,4,5,7,1,3,7,7,7,7,3,7,5,7,64.2490000724792,NA,NA,"","",NA
"1376",10,11,13,8,11,12,3,5,6,6,6,7,6,4,7,4,7,4,57.188000202179,43,"female","Venezuela (República Bolivariana de)","Bachillerato",2
"1377",14,10,14,13,13,7,7,6,5,2,7,7,7,7,6,7,6,4,58.4129998683929,40,"male","Bolivia (Estado Plurinacional de)","Licenciatura",7
"1380",13,12,14,14,12,13,7,7,7,6,7,7,7,6,5,7,5,7,62.5710000991821,40,"female","Honduras","Bachillerato",NA
"1383",14,8,14,14,9,6,7,7,5,1,7,7,7,7,7,2,7,1,87.7400000095367,NA,NA,"","",NA
"1386",13,13,14,13,13,7,6,7,3,4,7,7,7,6,7,6,6,7,64.3000001907349,23,"male","Venezuela (República Bolivariana de)","Bachillerato",3
"1387",12,11,12,12,11,6,6,6,3,3,6,6,6,6,6,5,5,6,50.2850000858307,34,"female","Venezuela (República Bolivariana de)","Grado profesional",1
"1389",14,14,14,14,14,5,7,7,4,1,7,7,7,7,7,7,7,7,91.220999956131,48,"female","Venezuela (República Bolivariana de)","Licenciatura",4
"1391",14,12,14,13,12,9,7,6,5,4,7,7,7,7,6,6,6,6,102.016000032425,32,NA,"Venezuela (República Bolivariana de)","Bachillerato",3
"1392",8,13,14,14,14,7,7,7,3,4,7,7,4,4,7,7,6,7,110.289000034332,34,"female","Venezuela (República Bolivariana de)","Licenciatura",1
"1398",13,14,14,13,12,5,6,7,4,1,7,7,6,7,5,7,7,7,66.518000125885,40,"male","Ecuador","Formación comercial/técnica/vocacional",2
"1399",14,14,14,14,14,2,7,7,1,1,7,7,7,7,7,7,7,7,60.7289998531342,51,"female","Venezuela (República Bolivariana de)","Grado profesional",3
"1400",4,8,11,14,14,8,7,7,4,4,7,4,2,2,7,7,4,4,48.3209998607635,34,"female","Venezuela (República Bolivariana de)","Licenciatura",1
"1403",14,14,14,14,13,5,7,7,2,3,7,7,7,7,6,7,7,7,74.1080000400543,33,"male","Venezuela (República Bolivariana de)","Formación comercial/técnica/vocacional",3
"1404",12,12,14,10,12,8,4,6,4,4,7,7,7,5,6,6,5,7,119.401999950409,22,"male","Bolivia (Estado Plurinacional de)","Bachillerato",7
"1405",11,8,13,14,10,9,7,7,4,5,6,7,6,5,5,5,3,5,68.1690001487732,49,"male","Perú","Formación comercial/técnica/vocacional",1
"1407",14,14,14,13,14,2,6,7,1,1,7,7,7,7,7,7,7,7,53.5590000152588,30,"female","Venezuela (República Bolivariana de)","Bachillerato",3
"1409",14,14,14,14,14,12,7,7,7,5,7,7,7,7,7,7,7,7,35.1180000305176,27,"male","Venezuela (República Bolivariana de)","Bachillerato",2
"1410",12,14,14,14,14,12,7,7,6,6,7,7,6,6,7,7,7,7,80.6429998874664,85,"female","Colombia","Grado profesional",NA
"1413",14,13,13,14,14,2,7,7,1,1,7,6,7,7,7,7,7,6,82.5590000152588,32,NA,"Venezuela (República Bolivariana de)","Formación comercial/técnica/vocacional",3
"1414",14,13,14,14,12,3,7,7,2,1,7,7,7,7,6,6,6,7,74.6480000019073,NA,NA,"","",NA
"1418",6,6,4,6,6,2,1,5,1,1,3,1,1,5,3,3,1,5,100.167999982834,30,NA,"México","Bachillerato",4
"1424",8,14,14,14,14,14,7,7,7,7,7,7,1,7,7,7,7,7,51.8230001926422,NA,"male","Argelia","Formación comercial/técnica/vocacional",NA
"1426",14,12,12,11,12,11,5,6,5,6,6,6,7,7,6,6,6,6,91.1840000152588,43,NA,"Argentina","Grado profesional",1
"1428",14,2,14,14,14,2,7,7,1,1,7,7,7,7,7,7,1,1,40.9790000915527,36,"female","Nicaragua","Licenciatura",2
"1429",11,11,11,11,11,7,7,4,4,3,4,7,7,4,7,4,7,4,32.4349999427795,32,NA,"Venezuela (República Bolivariana de)","Licenciatura",2
"1431",14,14,14,14,14,10,7,7,3,7,7,7,7,7,7,7,7,7,68.4200000762939,30,"female","Colombia","Bachillerato",1
"1432",14,12,11,10,10,6,3,7,4,2,4,7,7,7,7,3,6,6,77.3239998817444,28,"female","","",NA
"1434",14,11,12,12,12,10,6,6,6,4,6,6,7,7,6,6,5,6,53.9559998512268,24,"female","Colombia","Bachillerato",NA
"1435",14,12,14,14,14,13,7,7,6,7,7,7,7,7,7,7,6,6,83.063000202179,27,"female","Bolivia (Estado Plurinacional de)","Bachillerato",3
"1438",8,6,9,14,14,12,7,7,5,7,5,4,4,4,7,7,2,4,50.6000001430511,47,"female","Argentina","Bachillerato",2
"1440",12,13,14,14,14,12,7,7,6,6,7,7,6,6,7,7,7,6,84.4989998340607,34,"female","Venezuela (República Bolivariana de)","Licenciatura",1
"1441",14,14,14,14,14,2,7,7,1,1,7,7,7,7,7,7,7,7,118.033000230789,36,NA,"Venezuela (República Bolivariana de)","Licenciatura",1
"1449",13,12,11,14,11,7,7,7,5,2,5,6,7,6,5,6,6,6,96.5910000801086,46,NA,"Venezuela (República Bolivariana de)","Formación comercial/técnica/vocacional",3
"1450",13,10,14,14,10,4,7,7,2,2,7,7,7,6,5,5,5,5,87.2769999504089,45,"female","Venezuela (República Bolivariana de)","Formación comercial/técnica/vocacional",NA
"1451",14,13,14,14,13,11,7,7,4,7,7,7,7,7,6,7,6,7,55.5139999389648,40,"female","Venezuela (República Bolivariana de)","Bachillerato",1
"1458",13,11,14,12,12,12,6,6,6,6,7,7,7,6,6,6,5,6,52.9169998168945,48,"female","Bolivia (Estado Plurinacional de)","Licenciatura",1
"1460",14,12,14,14,14,14,7,7,7,7,7,7,7,7,7,7,7,5,74.1349999904633,53,"female","Venezuela (República Bolivariana de)","Bachillerato",1
"1462",12,8,14,14,10,10,7,7,5,5,7,7,6,6,4,6,1,7,60.6889998912811,41,"female","Venezuela (República Bolivariana de)","Licenciatura",1
"1463",13,12,14,14,14,12,7,7,7,5,7,7,7,6,7,7,6,6,37.2409999370575,34,"male","Argentina","Bachillerato",NA
"1464",9,9,14,11,13,8,5,6,6,2,7,7,4,5,7,6,4,5,84.3590002059937,21,"female","Venezuela (República Bolivariana de)","Bachillerato",4
"1466",12,12,14,13,12,8,6,7,6,2,7,7,6,6,6,6,6,6,81.8780000209808,58,NA,"","Grado profesional",2
"1469",14,11,14,11,14,11,4,7,7,4,7,7,7,7,7,7,4,7,60.0890002250671,19,"female","Honduras","Bachillerato",NA
"1470",13,5,14,11,8,9,4,7,5,4,7,7,6,7,4,4,1,4,52.7820000648499,74,"male","Argentina","Formación comercial/técnica/vocacional",3
"1471",14,10,14,13,14,10,7,6,3,7,7,7,7,7,7,7,4,6,75.3819999694824,50,"male","Argentina","Formación comercial/técnica/vocacional",3
"1473",12,11,13,14,14,11,7,7,5,6,7,6,6,6,7,7,6,5,61.5490000247955,32,"male","El Salvador","Bachillerato",NA
"1474",14,9,14,9,13,9,3,6,2,7,7,7,7,7,6,7,5,4,95.0199999809265,NA,NA,"","",NA
"1476",12,14,14,14,14,2,7,7,1,1,7,7,6,6,7,7,7,7,33.0140001773834,24,NA,"Venezuela (República Bolivariana de)","Formación comercial/técnica/vocacional",1
"1477",11,13,9,12,13,8,6,6,4,4,4,5,6,5,6,7,7,6,55.6530001163483,40,"female","Bolivia (Estado Plurinacional de)","Licenciatura",3
"1478",14,14,12,13,13,3,6,7,1,2,5,7,7,7,6,7,7,7,45.4749999046326,33,"male","Honduras","Bachillerato",1
"1482",11,14,8,11,14,8,7,4,4,4,4,4,7,4,7,7,7,7,101.419000148773,41,"male","Venezuela (República Bolivariana de)","Bachillerato",4
"1487",12,14,12,14,7,2,7,7,1,1,6,6,6,6,6,1,7,7,110.490000009537,68,"male","Venezuela (República Bolivariana de)","Licenciatura",1
"1488",14,14,14,14,14,2,7,7,1,1,7,7,7,7,7,7,7,7,82.1779999732971,39,NA,"Perú","Bachillerato",1
"1489",10,6,14,11,12,4,5,6,2,2,7,7,5,5,6,6,5,1,39.9909999370575,NA,NA,"","",NA
"1490",12,8,14,10,11,10,4,6,6,4,7,7,7,5,7,4,4,4,108.117000102997,47,"female","Venezuela (República Bolivariana de)","Bachillerato",4
"1492",10,10,13,13,11,9,6,7,5,4,7,6,6,4,5,6,4,6,67.1979999542236,34,"male","Argentina","Grado de asociado",1
"1496",11,8,13,12,13,8,6,6,5,3,7,6,5,6,6,7,5,3,60.9099998474121,40,NA,"Bolivia (Estado Plurinacional de)","Bachillerato",2
"1498",12,12,12,13,14,11,6,7,6,5,6,6,6,6,7,7,6,6,62.1600000858307,35,NA,"Venezuela (República Bolivariana de)","Licenciatura",3
"1499",14,12,14,13,14,12,7,6,7,5,7,7,7,7,7,7,7,5,66.3140001296997,26,"female","Venezuela (República Bolivariana de)","Licenciatura",6
"1500",14,12,14,14,10,12,7,7,7,5,7,7,7,7,5,5,6,6,47.0909998416901,27,"female","Nicaragua","Licenciatura",2
"1507",11,7,14,11,13,13,5,6,7,6,7,7,6,5,7,6,5,2,69.7560000419617,44,"male","Bolivia (Estado Plurinacional de)","Licenciatura",1
"1522",13,9,14,13,12,8,6,7,5,3,7,7,7,6,5,7,4,5,61.4560000896454,NA,NA,"","",NA
"1533",13,14,14,14,14,11,7,7,6,5,7,7,6,7,7,7,7,7,63.7800002098083,NA,NA,"","",NA
"1535",14,14,14,14,14,2,7,7,1,1,7,7,7,7,7,7,7,7,65.5930001735687,34,NA,"Colombia","Bachillerato",2
"1536",14,14,14,14,14,6,7,7,1,5,7,7,7,7,7,7,7,7,62.0169999599457,43,"female","Venezuela (República Bolivariana de)","Licenciatura",2
"1539",13,14,14,13,12,10,7,6,5,5,7,7,7,6,5,7,7,7,70.0139999389648,39,"female","Venezuela (República Bolivariana de)","Licenciatura",1
"1540",12,5,11,13,12,2,6,7,1,1,5,6,6,6,6,6,3,2,68.1399998664856,NA,NA,"","",NA
"1543",14,14,12,14,14,2,7,7,1,1,7,5,7,7,7,7,7,7,32.1350002288818,18,"female","Colombia","Bachillerato",NA
"1544",14,14,14,14,6,7,7,7,4,3,7,7,7,7,5,1,7,7,103.943000078201,36,NA,"Venezuela (República Bolivariana de)","",1
"1545",14,12,14,14,14,13,7,7,6,7,7,7,7,7,7,7,6,6,57.2330002784729,29,NA,"Venezuela (República Bolivariana de)","Grado profesional",1
"1547",13,14,11,14,14,13,7,7,6,7,7,4,7,6,7,7,7,7,44.8980000019073,33,"male","Colombia","Formación comercial/técnica/vocacional",1
"1549",13,14,14,12,14,8,6,6,5,3,7,7,7,6,7,7,7,7,39.1780002117157,NA,"female","México","Bachillerato",3
"1554",6,8,12,14,12,6,7,7,2,4,6,6,4,2,5,7,5,3,64.923999786377,25,NA,"Nicaragua","Grado profesional",5
"1555",14,14,14,14,13,9,7,7,4,5,7,7,7,7,6,7,7,7,79.7089998722076,36,NA,"México","Licenciatura",3
"1557",11,11,12,11,10,5,6,5,3,2,6,6,5,6,5,5,6,5,95.9849998950958,27,"female","El Salvador","Bachillerato",2
"1565",14,13,12,14,10,6,7,7,3,3,6,6,7,7,7,3,7,6,71.0680000782013,30,"female","Bolivia (Estado Plurinacional de)","Formación comercial/técnica/vocacional",1
"1567",13,13,13,11,12,5,4,7,3,2,7,6,6,7,5,7,6,7,48.7980000972748,55,NA,"","",NA
"1568",14,14,14,14,14,10,7,7,5,5,7,7,7,7,7,7,7,7,70.5099999904633,60,NA,"Venezuela (República Bolivariana de)","Maestría",7
"1569",13,8,14,14,14,11,7,7,5,6,7,7,6,7,7,7,5,3,51.6669998168945,NA,NA,"","",NA
"1571",13,10,14,14,10,11,7,7,5,6,7,7,7,6,6,4,5,5,58.9769997596741,36,"female","Colombia","Formación comercial/técnica/vocacional",1
"1577",13,13,14,14,14,13,7,7,6,7,7,7,6,7,7,7,7,6,41.0870001316071,54,"female","Argentina","Bachillerato",2
"1581",12,11,14,14,11,12,7,7,7,5,7,7,7,5,4,7,6,5,63.7080001831055,45,"female","Venezuela (República Bolivariana de)","Grado profesional",1
"1587",14,14,14,14,14,2,7,7,1,1,7,7,7,7,7,7,7,7,54.3180000782013,27,"female","Venezuela (República Bolivariana de)","Bachillerato",1
"1589",14,14,12,13,13,6,7,6,5,1,6,6,7,7,6,7,7,7,86.3889999389648,37,"female","","Grado profesional",1
"1593",13,10,12,14,12,13,7,7,6,7,7,5,6,7,6,6,5,5,53.6260001659393,20,"male","Nicaragua","Bachillerato",5
"1598",8,14,14,14,14,14,7,7,7,7,7,7,7,1,7,7,7,7,61.7699999809265,36,"male","Colombia","Grado profesional",1
"1600",14,14,11,10,14,10,4,6,4,6,6,5,7,7,7,7,7,7,59.1730000972748,52,NA,"Venezuela (República Bolivariana de)","Licenciatura",NA
"1602",14,14,14,11,14,9,4,7,3,6,7,7,7,7,7,7,7,7,51.5859999656677,29,"female","Honduras","Bachillerato",5
"1603",13,14,14,11,13,12,4,7,7,5,7,7,7,6,6,7,7,7,82.2109999656677,34,NA,"Bolivia (Estado Plurinacional de)","Formación comercial/técnica/vocacional",1
"1604",14,11,14,14,13,13,7,7,6,7,7,7,7,7,6,7,5,6,39.4340000152588,26,"male","Guatemala","Maestría",3
"1605",14,14,14,14,13,14,7,7,7,7,7,7,7,7,6,7,7,7,37.5520000457764,26,"male","Guatemala","Maestría",3
"1606",13,11,12,13,14,9,6,7,5,4,6,6,7,6,7,7,5,6,58.6180000305176,29,"male","El Salvador","Bachillerato",3
"1608",14,14,13,13,12,9,6,7,5,4,6,7,7,7,7,5,7,7,40.2249999046326,NA,NA,"","",NA
"1609",13,9,12,13,12,7,6,7,3,4,6,6,7,6,6,6,4,5,52.1489999294281,27,"female","Guatemala","Licenciatura",1
"1615",14,13,12,13,8,11,6,7,6,5,6,6,7,7,2,6,6,7,63.9850001335144,64,"male","Venezuela (República Bolivariana de)","Grado profesional",NA
"1616",14,14,14,12,11,7,5,7,3,4,7,7,7,7,4,7,7,7,51.5699999332428,54,"female","Honduras","Licenciatura",1
"1617",12,11,12,11,13,10,6,5,4,6,6,6,6,6,6,7,6,5,53.8589999675751,54,"male","Paraguay","Bachillerato",1
"1622",5,4,6,4,6,6,2,2,4,2,4,2,1,4,2,4,2,2,124.244999885559,NA,"female","Venezuela (República Bolivariana de)","Licenciatura",4
"1623",14,12,14,14,14,9,7,7,7,2,7,7,7,7,7,7,6,6,84.7950000762939,29,"female","Paraguay","Grado profesional",1
"1624",14,14,14,14,12,10,7,7,3,7,7,7,7,7,6,6,7,7,84.7810001373291,44,"female","Venezuela (República Bolivariana de)","Licenciatura",1
"1626",12,11,12,12,12,9,5,7,6,3,6,6,6,6,6,6,6,5,66.8439998626709,48,NA,"","Bachillerato",1
"1629",13,12,14,14,13,2,7,7,1,1,7,7,7,6,6,7,6,6,61.8830001354218,30,"male","Venezuela (República Bolivariana de)","",1
"1637",14,14,14,14,14,13,7,7,6,7,7,7,7,7,7,7,7,7,39.0770001411438,NA,NA,"","",NA
"1638",12,9,12,12,10,2,7,5,1,1,5,7,6,6,4,6,4,5,58.8199999332428,24,"female","Bolivia (Estado Plurinacional de)","Licenciatura",6
"1641",10,9,11,8,7,5,5,3,2,3,6,5,5,5,3,4,5,4,39.4030001163483,55,"female","Venezuela (República Bolivariana de)","Licenciatura",1
"1642",14,14,13,13,14,5,6,7,3,2,7,6,7,7,7,7,7,7,111.638000011444,33,NA,"Venezuela (República Bolivariana de)","Grado profesional",2
"1644",9,12,12,11,12,9,5,6,5,4,7,5,5,4,6,6,6,6,51.6680002212524,29,"male","Bolivia (Estado Plurinacional de)","Licenciatura",3
"1646",14,13,14,13,13,11,7,6,5,6,7,7,7,7,6,7,7,6,101.373000144958,NA,NA,"","",NA
"1648",12,10,10,11,9,9,5,6,5,4,5,5,6,6,4,5,5,5,80.6909999847412,23,"male","Bolivia (Estado Plurinacional de)","Formación comercial/técnica/vocacional",4
"1650",14,14,14,14,14,2,7,7,1,1,7,7,7,7,7,7,7,7,53.0999999046326,NA,NA,"","",NA
"1651",14,14,14,14,14,9,7,7,4,5,7,7,7,7,7,7,7,7,42.1929998397827,38,"male","","Grado profesional",3
"1655",14,11,14,13,13,14,6,7,7,7,7,7,7,7,7,6,5,6,72.3410000801086,54,NA,"Venezuela (República Bolivariana de)","Licenciatura",3
"1656",12,8,14,14,13,9,7,7,7,2,7,7,7,5,7,6,4,4,64.981999874115,40,"female","Nicaragua","",NA
"1659",14,13,14,14,14,7,7,7,6,1,7,7,7,7,7,7,6,7,67.2879998683929,42,"female","Bolivia (Estado Plurinacional de)","Licenciatura",3
"1660",10,12,13,9,13,4,4,5,2,2,7,6,5,5,7,6,6,6,139.632999897003,21,"male","Venezuela (República Bolivariana de)","Formación comercial/técnica/vocacional",5
"1661",13,10,14,13,13,10,6,7,6,4,7,7,7,6,7,6,5,5,77.3729999065399,49,"male","Venezuela (República Bolivariana de)","Bachillerato",7
"1662",14,10,14,14,14,14,7,7,7,7,7,7,7,7,7,7,7,3,74.3360002040863,31,"female","Nicaragua","Bachillerato",1
"1665",14,14,14,14,14,8,7,7,4,4,7,7,7,7,7,7,7,7,61.5759999752045,37,"female","Venezuela (República Bolivariana de)","Grado profesional",3
"1666",14,8,13,13,10,8,7,6,2,6,6,7,7,7,5,5,5,3,134.298000097275,45,"female","Venezuela (República Bolivariana de)","Bachillerato",1
"1674",14,14,14,14,2,6,7,7,5,1,7,7,7,7,1,1,7,7,80.3810000419617,42,"male","Ecuador","Grado profesional",NA
"1675",14,14,12,14,10,5,7,7,4,1,5,7,7,7,5,5,7,7,107.325000047684,50,"female","","",1
"1676",14,11,14,12,12,7,7,5,6,1,7,7,7,7,6,6,5,6,58.5380001068115,38,"female","Venezuela (República Bolivariana de)","Licenciatura",7
