,philanthropist,socializer,freeSpirit,achiever,player,disruptor,A2,A4,D3,D4,F1,F3,P1,P4,R2,R4,S2,S4,Completion Time,Age,Gender,Country,Education,Freq Games
4,14,14,13,14,7,7,7,7,6,1,6,7,7,7,5,2,7,7,85.86799979,75,NA,,,1
5,14,14,14,14,14,2,7,7,1,1,7,7,7,7,7,7,7,7,75.56699991,NA,NA,,,NA
6,13,10,11,9,13,10,3,6,4,6,5,6,7,6,7,6,6,4,42.2809999,NA,NA,,,NA
7,13,2,14,9,2,5,5,4,4,1,7,7,7,6,1,1,1,1,66.02799988,69,female,Argentina,Technical or vocational training,7
9,13,6,13,13,6,7,6,7,6,1,6,7,7,6,1,5,1,5,91.74799991,72,female,Venezuela (República Bolivariana de),Professional degree,7
12,14,14,14,14,14,10,7,7,5,5,7,7,7,7,7,7,7,7,41.45099974,65,female,Argentina,,NA
14,14,14,14,13,14,2,6,7,1,1,7,7,7,7,7,7,7,7,64.92799997,NA,NA,,,NA
17,14,8,14,14,13,11,7,7,7,4,7,7,7,7,6,7,1,7,47.87099981,66,female,,,NA
19,14,4,14,8,13,3,2,6,1,2,7,7,7,7,7,6,2,2,98.21199989,40,female,Venezuela (República Bolivariana de),Technical or vocational training,1
24,14,14,13,13,13,2,6,7,1,1,7,6,7,7,7,6,7,7,102.8820002,80,female,Argentina,Master's degree,4
25,12,12,14,13,14,14,6,7,7,7,7,7,6,6,7,7,6,6,43.33899999,59,male,Argentina,Technical or vocational training,5
27,12,14,14,14,14,11,7,7,7,4,7,7,6,6,7,7,7,7,49.82700014,67,NA,Argentina,Technical or vocational training,1
28,13,9,14,14,14,9,7,7,6,3,7,7,6,7,7,7,6,3,83.04700017,65,male,Nicaragua,Master's degree,NA
30,14,14,14,14,14,13,7,7,6,7,7,7,7,7,7,7,7,7,119.1610003,NA,NA,,,NA
35,8,5,13,7,7,7,3,4,3,4,7,6,4,4,3,4,3,2,53.4289999,52,NA,,Bachelor's degree,NA
36,14,14,14,14,13,6,7,7,5,1,7,7,7,7,6,7,7,7,56.60500002,42,NA,Venezuela (República Bolivariana de),Bachelor's degree,1
42,14,14,14,14,14,2,7,7,1,1,7,7,7,7,7,7,7,7,90.60299969,NA,NA,,,NA
43,14,14,14,12,11,2,5,7,1,1,7,7,7,7,5,6,7,7,70.32300019,56,female,Venezuela (República Bolivariana de),High School diploma,NA
45,14,14,11,14,2,5,7,7,4,1,4,7,7,7,1,1,7,7,72.85599995,NA,NA,,,NA
46,14,3,12,12,14,11,5,7,5,6,5,7,7,7,7,7,1,2,60.64699984,51,NA,Colombia,High School diploma,1
47,14,14,14,13,8,3,6,7,1,2,7,7,7,7,6,2,7,7,74.52600002,31,female,Guatemala,High School diploma,NA
51,14,14,14,11,4,8,5,6,6,2,7,7,7,7,3,1,7,7,81.5539999,57,female,Venezuela (República Bolivariana de),High School diploma,1
52,14,11,14,14,12,8,7,7,3,5,7,7,7,7,6,6,4,7,50.34200001,NA,NA,,,NA
55,12,12,11,13,14,4,6,7,3,1,6,5,7,5,7,7,7,5,107.6200001,63,female,Venezuela (República Bolivariana de),Master's degree,7
56,14,11,14,11,14,8,4,7,5,3,7,7,7,7,7,7,6,5,63.5250001,63,female,Uruguay,Technical or vocational training,7
58,14,11,14,13,10,8,6,7,4,4,7,7,7,7,5,5,5,6,60.55799985,74,female,Argentina,High School diploma,7
59,2,7,4,3,4,7,2,1,5,2,3,1,1,1,2,2,4,3,70.67699981,55,NA,Venezuela (República Bolivariana de),Technical or vocational training,1
60,14,12,11,12,10,6,6,6,4,2,7,4,7,7,5,5,6,6,75.3210001,59,male,Venezuela (República Bolivariana de),High School diploma,3
61,12,8,13,13,5,14,7,6,7,7,6,7,6,6,1,4,4,4,70.26099992,NA,NA,,,NA
62,10,7,10,12,12,6,6,6,3,3,5,5,5,5,6,6,3,4,62.40799999,60,NA,Argentina,High School diploma,7
63,14,8,14,14,4,13,7,7,7,6,7,7,7,7,2,2,5,3,96.42000008,58,male,,High School diploma,1
65,14,7,13,14,13,2,7,7,1,1,7,6,7,7,7,6,2,5,89.76499987,66,NA,Argentina,High School diploma,NA
66,14,9,12,13,13,2,6,7,1,1,6,6,7,7,6,7,2,7,88.79200006,43,female,Colombia,Technical or vocational training,1
68,14,14,14,13,10,4,6,7,1,3,7,7,7,7,6,4,7,7,90.34299994,82,male,Venezuela (República Bolivariana de),High School diploma,1
69,14,14,14,14,14,13,7,7,7,6,7,7,7,7,7,7,7,7,55.30600023,30,female,Venezuela (República Bolivariana de),High School diploma,5
72,14,14,13,12,14,2,6,6,1,1,7,6,7,7,7,7,7,7,51.25600004,NA,NA,,,NA
74,14,14,14,13,5,8,6,7,6,2,7,7,7,7,4,1,7,7,103.592,NA,NA,,,NA
75,9,11,12,10,13,12,5,5,6,6,6,6,4,5,7,6,4,7,68.28200006,60,NA,Venezuela (República Bolivariana de),Professional degree,7
79,7,7,12,13,14,11,7,6,6,5,6,6,3,4,7,7,4,3,59.39300013,53,female,Venezuela (República Bolivariana de),Master's degree,1
80,14,14,14,14,2,14,7,7,7,7,7,7,7,7,1,1,7,7,77.27600002,66,male,Colombia,High School diploma,NA
82,14,13,12,13,9,10,6,7,5,5,6,6,7,7,5,4,7,6,68.23900008,73,NA,Paraguay,Professional degree,NA
83,14,14,11,13,10,6,6,7,4,2,7,4,7,7,7,3,7,7,59.14400005,58,female,Argentina,High School diploma,1
85,14,14,14,12,13,6,6,6,3,3,7,7,7,7,7,6,7,7,100.2279997,70,female,Venezuela (República Bolivariana de),Technical or vocational training,7
87,14,11,14,14,14,5,7,7,1,4,7,7,7,7,7,7,6,5,68.0400002,62,male,Venezuela (República Bolivariana de),Bachelor's degree,1
90,14,10,11,11,9,4,5,6,2,2,5,6,7,7,4,5,5,5,115.5349998,70,female,Argentina,Professional degree,1
91,12,6,14,14,14,11,7,7,4,7,7,7,6,6,7,7,3,3,104.2579999,56,male,Venezuela (República Bolivariana de),High School diploma,NA
93,14,10,5,8,11,6,4,4,2,4,1,4,7,7,4,7,6,4,104.069,29,NA,Venezuela (República Bolivariana de),High School diploma,1
94,13,14,8,12,14,5,5,7,1,4,1,7,7,6,7,7,7,7,43.64400005,19,female,Venezuela (República Bolivariana de),High School diploma,1
95,14,11,14,9,13,13,5,4,7,6,7,7,7,7,7,6,4,7,54.00199986,54,female,Perú,Technical or vocational training,2
97,14,13,14,14,14,8,7,7,6,2,7,7,7,7,7,7,6,7,68.30499983,NA,NA,,,NA
98,14,14,13,13,14,12,6,7,6,6,7,6,7,7,7,7,7,7,63.37599993,56,female,Colombia,High School diploma,1
99,7,7,13,13,10,12,7,6,7,5,7,6,4,3,5,5,3,4,102.8789997,63,male,Colombia,High School diploma,1
100,13,10,14,12,8,9,6,6,5,4,7,7,7,6,4,4,5,5,70.21300006,60,female,Argentina,Master's degree,NA
105,14,11,12,10,11,10,4,6,4,6,6,6,7,7,4,7,6,5,77.42499995,65,female,Venezuela (República Bolivariana de),Technical or vocational training,4
107,14,14,14,14,12,2,7,7,1,1,7,7,7,7,5,7,7,7,52.64299989,68,NA,Nicaragua,Bachelor's degree,5
108,10,10,13,12,10,12,6,6,6,6,6,7,5,5,5,5,6,4,70.05199981,50,male,,High School diploma,2
110,14,12,14,14,13,13,7,7,7,6,7,7,7,7,6,7,6,6,90.28699994,67,female,Argentina,High School diploma,4
111,12,8,12,13,8,9,6,7,4,5,6,6,6,6,5,3,4,4,132.0180001,NA,NA,,,NA
112,14,14,14,14,14,8,7,7,3,5,7,7,7,7,7,7,7,7,54.04499984,34,NA,Colombia,Technical or vocational training,1
113,10,11,11,12,7,9,6,6,6,3,6,5,6,4,1,6,5,6,62.59100008,64,male,Argentina,Master's degree,1
120,13,10,12,13,13,11,6,7,5,6,5,7,7,6,6,7,5,5,102.9679999,NA,NA,,,NA
121,10,13,13,11,11,9,5,6,5,4,6,7,6,4,6,5,7,6,44.81999993,69,female,Argentina,High School diploma,7
122,14,14,14,14,14,2,7,7,1,1,7,7,7,7,7,7,7,7,84.03400016,61,male,Venezuela (República Bolivariana de),,NA
123,14,14,14,14,14,6,7,7,3,3,7,7,7,7,7,7,7,7,64.34899998,NA,NA,,,NA
127,13,12,14,14,14,12,7,7,7,5,7,7,7,6,7,7,5,7,62.27199984,NA,NA,,,NA
129,14,14,14,13,8,2,7,6,1,1,7,7,7,7,5,3,7,7,54.60800028,NA,NA,,,NA
130,14,13,14,13,10,11,7,6,6,5,7,7,7,7,4,6,6,7,61.22799993,NA,female,Argentina,Professional degree,1
131,13,7,8,9,5,8,4,5,4,4,4,4,7,6,1,4,4,3,66.58500004,39,female,Venezuela (República Bolivariana de),High School diploma,1
133,14,11,14,13,14,14,6,7,7,7,7,7,7,7,7,7,6,5,78.5170002,63,female,Argentina,High School diploma,NA
134,10,12,14,11,10,9,5,6,3,6,7,7,5,5,5,5,6,6,80.08200026,57,male,Venezuela (República Bolivariana de),High School diploma,1
136,14,14,13,14,10,4,7,7,3,1,7,6,7,7,7,3,7,7,63.99899983,58,female,Argentina,Professional degree,NA
138,14,9,14,13,9,3,6,7,1,2,7,7,7,7,2,7,7,2,68.28799987,58,male,Venezuela (República Bolivariana de),Technical or vocational training,1
139,14,14,14,14,14,2,7,7,1,1,7,7,7,7,7,7,7,7,77.20600009,48,female,Perú,,NA
140,14,14,14,12,13,6,6,6,1,5,7,7,7,7,6,7,7,7,81.21999979,81,female,Argentina,High School diploma,7
145,14,10,14,14,10,14,7,7,7,7,7,7,7,7,5,5,5,5,53.26800013,60,female,El Salvador,Bachelor's degree,NA
146,14,14,7,14,13,14,7,7,7,7,6,1,7,7,6,7,7,7,83.92499995,NA,male,,,NA
149,12,10,13,10,10,11,5,5,4,7,6,7,6,6,5,5,5,5,68.42600012,67,NA,Argentina,Technical or vocational training,1
150,7,7,14,10,12,5,3,7,3,2,7,7,6,1,7,5,1,6,67.43300009,80,female,Argentina,Professional degree,2
153,14,10,14,14,14,8,7,7,4,4,7,7,7,7,7,7,5,5,44.96000004,NA,NA,,,NA
154,14,12,14,14,14,2,7,7,1,1,7,7,7,7,7,7,7,5,69.99399996,53,male,Colombia,High School diploma,NA
156,12,12,12,11,12,11,5,6,5,6,6,6,6,6,6,6,6,6,56.05200005,77,NA,Argentina,Technical or vocational training,6
157,14,7,13,14,14,2,7,7,1,1,6,7,7,7,7,7,1,6,135.0769997,67,female,Argentina,,2
158,14,12,11,12,12,6,6,6,5,1,6,5,7,7,5,7,7,5,47.18000007,56,female,Argentina,Bachelor's degree,NA
163,12,12,11,13,12,11,6,7,4,7,5,6,6,6,6,6,5,7,67.55900002,58,female,Colombia,High School diploma,1
164,14,14,13,12,11,3,6,6,2,1,6,7,7,7,5,6,7,7,86.25699997,67,male,Venezuela (República Bolivariana de),High School diploma,1
165,14,14,2,14,14,2,7,7,1,1,1,1,7,7,7,7,7,7,93.51499987,NA,NA,,,NA
167,13,10,14,13,10,7,6,7,1,6,7,7,6,7,5,5,5,5,75.22500014,62,female,,Technical or vocational training,NA
168,14,8,14,14,14,2,7,7,1,1,7,7,7,7,7,7,7,1,64.17000008,NA,NA,,,NA
169,9,6,14,13,9,10,7,6,7,3,7,7,4,5,5,4,4,2,94.30500007,63,male,Colombia,High School diploma,1
171,13,14,12,14,11,6,7,7,1,5,6,6,7,6,4,7,7,7,39.82700014,50,female,Bolivia (Estado Plurinacional de),Doctorate,1
172,14,11,14,13,10,2,7,6,1,1,7,7,7,7,6,4,4,7,124.6190002,NA,NA,,,NA
174,8,12,14,14,14,12,7,7,7,5,7,7,7,1,7,7,6,6,86.36699986,67,female,Argentina,High School diploma,1
182,13,11,14,13,11,9,6,7,3,6,7,7,6,7,5,6,5,6,65.34699988,47,female,Perú,Technical or vocational training,1
183,13,14,14,14,14,14,7,7,7,7,7,7,7,6,7,7,7,7,30.4150002,43,female,Venezuela (República Bolivariana de),High School diploma,1
184,11,14,14,13,14,10,6,7,7,3,7,7,6,5,7,7,7,7,93.15799999,NA,NA,,,NA
186,13,14,12,12,14,11,5,7,5,6,6,6,7,6,7,7,7,7,75.1400001,62,female,Paraguay,Bachelor's degree,5
188,13,8,14,14,12,10,7,7,3,7,7,7,7,6,5,7,5,3,59.91300011,53,NA,Argentina,Professional degree,1
189,14,12,14,12,12,2,6,6,1,1,7,7,7,7,6,6,6,6,71.96199989,70,female,Argentina,Professional degree,1
193,14,9,14,14,14,8,7,7,6,2,7,7,7,7,7,7,7,2,86.52099991,49,female,Colombia,High School diploma,1
194,11,2,14,14,11,14,7,7,7,7,7,7,6,5,4,7,1,1,56.671,NA,NA,,,NA
196,14,12,12,13,12,3,6,7,2,1,6,6,7,7,6,6,6,6,64.56299996,57,male,Colombia,Bachelor's degree,1
199,7,7,11,13,13,6,6,7,4,2,5,6,4,3,7,6,4,3,60.45699978,49,NA,Argentina,Bachelor's degree,7
202,14,14,14,14,14,2,7,7,1,1,7,7,7,7,7,7,7,7,95.39300013,36,NA,Venezuela (República Bolivariana de),Professional degree,1
203,14,14,14,14,2,2,7,7,1,1,7,7,7,7,1,1,7,7,65.89299989,66,female,,,3
204,11,10,12,13,12,3,7,6,1,2,7,5,7,4,6,6,4,6,67.62699986,19,male,Venezuela (República Bolivariana de),High School diploma,3
205,11,13,2,10,8,2,5,5,1,1,1,1,7,4,4,4,7,6,59.57599998,46,male,Argentina,Master's degree,1
206,11,12,14,13,12,12,7,6,5,7,7,7,7,4,7,5,6,6,84.35899997,NA,female,,,7
207,13,12,14,12,14,7,5,7,4,3,7,7,6,7,7,7,5,7,62.87999988,NA,NA,,,NA
211,14,12,14,12,13,7,5,7,1,6,7,7,7,7,6,7,6,6,73.30600023,50,female,Colombia,Professional degree,1
212,14,13,14,13,12,7,6,7,1,6,7,7,7,7,7,5,7,6,107.392,56,female,Argentina,High School diploma,1
213,14,11,14,13,12,2,6,7,1,1,7,7,7,7,5,7,5,6,66.52999997,59,female,Argentina,,1
214,14,14,14,14,14,7,7,7,2,5,7,7,7,7,7,7,7,7,67.53600025,45,male,Venezuela (República Bolivariana de),Technical or vocational training,2
217,14,14,14,14,14,10,7,7,3,7,7,7,7,7,7,7,7,7,38.30599976,NA,NA,,,NA
219,14,14,14,14,14,2,7,7,1,1,7,7,7,7,7,7,7,7,65.204,NA,NA,,,NA
220,11,9,14,11,13,7,5,6,6,1,7,7,5,6,6,7,6,3,79.47699976,69,male,Argentina,Technical or vocational training,NA
223,14,8,14,14,14,13,7,7,7,6,7,7,7,7,7,7,4,4,50.21700001,NA,NA,,,NA
225,12,12,13,14,14,12,7,7,6,6,7,6,6,6,7,7,6,6,61.16400003,64,NA,Colombia,Technical or vocational training,7
226,14,8,10,13,13,8,6,7,6,2,4,6,7,7,7,6,5,3,51.38699985,56,NA,Argentina,Professional degree,1
227,6,11,13,14,6,6,7,7,5,1,6,7,3,3,4,2,5,6,70.45599985,71,NA,Argentina,Bachelor's degree,6
228,8,2,14,14,11,14,7,7,7,7,7,7,1,7,7,4,1,1,56.71800017,52,NA,Venezuela (República Bolivariana de),High School diploma,4
230,12,10,12,8,12,7,3,5,4,3,6,6,6,6,6,6,5,5,111.543,NA,NA,,,NA
231,14,14,14,12,12,3,6,6,2,1,7,7,7,7,6,6,7,7,82.21300006,80,female,Costa Rica,Bachelor's degree,3
233,14,12,14,12,14,10,6,6,4,6,7,7,7,7,7,7,6,6,46.95200014,56,female,Perú,Professional degree,1
235,14,9,14,14,4,8,7,7,3,5,7,7,7,7,2,2,4,5,53.91599989,45,female,Chile,Technical or vocational training,NA
236,10,6,11,14,9,8,7,7,4,4,4,7,6,4,5,4,2,4,71.3900001,32,female,Colombia,High School diploma,4
238,14,13,13,13,13,14,6,7,7,7,7,6,7,7,6,7,7,6,49.08200002,NA,NA,,,NA
240,14,14,10,14,4,10,7,7,7,3,7,3,7,7,3,1,7,7,70.671,58,female,Argentina,,1
242,14,14,14,12,11,2,6,6,1,1,7,7,7,7,5,6,7,7,85.44300008,80,female,Argentina,Master's degree,6
243,14,13,9,14,14,9,7,7,5,4,5,4,7,7,7,7,7,6,63.45599985,72,male,Argentina,Master's degree,1
244,14,14,14,14,14,4,7,7,3,1,7,7,7,7,7,7,7,7,58.48000002,65,female,Argentina,Professional degree,NA
246,13,11,14,14,9,8,7,7,2,6,7,7,7,6,3,6,5,6,84.15899992,28,NA,El Salvador,High School diploma,1
249,14,11,14,14,14,11,7,7,6,5,7,7,7,7,7,7,7,4,137.9160001,71,female,Argentina,High School diploma,3
250,12,13,14,14,14,13,7,7,7,6,7,7,6,6,7,7,7,6,76.63999987,85,female,,Professional degree,1
251,14,11,14,14,14,14,7,7,7,7,7,7,7,7,7,7,7,4,80.23500013,58,female,Argentina,Technical or vocational training,3
252,14,6,14,12,10,2,5,7,1,1,7,7,7,7,6,4,3,3,77.59600019,66,female,Argentina,High School diploma,7
255,14,5,14,14,14,14,7,7,7,7,7,7,7,7,7,7,4,1,33.61199999,29,NA,Venezuela (República Bolivariana de),High School diploma,1
256,14,12,14,14,12,11,7,7,6,5,7,7,7,7,5,7,5,7,63.12100005,71,NA,Argentina,,NA
258,14,14,13,13,13,14,6,7,7,7,7,6,7,7,6,7,7,7,68.70499992,65,female,,,NA
262,14,14,12,14,12,3,7,7,2,1,6,6,7,7,6,6,7,7,81.47099996,67,male,,High School diploma,NA
263,14,14,14,13,14,2,6,7,1,1,7,7,7,7,7,7,7,7,59.25,57,NA,Colombia,High School diploma,1
267,14,8,11,11,11,11,7,4,5,6,4,7,7,7,7,4,4,4,63.67900014,63,female,Argentina,High School diploma,5
268,14,14,14,14,13,14,7,7,7,7,7,7,7,7,6,7,7,7,46.37899971,85,NA,,Professional degree,NA
269,10,6,14,12,5,8,6,6,6,2,7,7,4,6,1,4,3,3,90.65100002,77,female,Argentina,High School diploma,5
272,14,14,14,12,11,2,6,6,1,1,7,7,7,7,6,5,7,7,82.51000023,80,female,Argentina,Technical or vocational training,NA
273,14,14,14,14,13,12,7,7,6,6,7,7,7,7,6,7,7,7,57.31699991,56,NA,,High School diploma,1
274,6,8,14,14,10,11,7,7,6,5,7,7,4,2,5,5,5,3,107.0860002,51,male,Argentina,High School diploma,1
275,14,12,13,11,4,9,5,6,7,2,6,7,7,7,2,2,6,6,84.66000009,54,NA,Venezuela (República Bolivariana de),High School diploma,NA
276,13,5,14,14,8,13,7,7,6,7,7,7,7,6,6,2,3,2,69.48400021,NA,NA,,,NA
282,14,8,14,14,14,2,7,7,1,1,7,7,7,7,7,7,1,7,58.579,66,NA,Argentina,Bachelor's degree,1
286,12,11,12,12,13,11,6,6,6,5,6,6,6,6,7,6,6,5,51.40799999,60,NA,Argentina,High School diploma,4
289,11,11,11,14,8,5,7,7,3,2,4,7,5,6,4,4,6,5,79.76900005,NA,NA,,,NA
292,12,10,12,13,14,8,6,7,4,4,7,5,6,6,7,7,5,5,81.68400002,19,male,Venezuela (República Bolivariana de),High School diploma,7
296,14,12,10,13,13,7,6,7,1,6,6,4,7,7,7,6,6,6,114.362,NA,NA,,,NA
297,12,11,14,14,14,13,7,7,7,6,7,7,7,5,7,7,5,6,57.74499989,22,male,Venezuela (República Bolivariana de),High School diploma,1
298,11,8,7,14,14,12,7,7,5,7,6,1,6,5,7,7,4,4,62.39399981,NA,NA,,,NA
299,13,14,13,12,7,8,6,6,6,2,6,7,6,7,6,1,7,7,64.37699986,NA,NA,,,NA
301,14,14,14,14,14,2,7,7,1,1,7,7,7,7,7,7,7,7,65.15499997,83,NA,Venezuela (República Bolivariana de),Bachelor's degree,NA
303,14,9,14,14,12,14,7,7,7,7,7,7,7,7,5,7,3,6,52.3039999,56,NA,Argentina,Technical or vocational training,1
305,14,14,13,13,13,7,7,6,5,2,7,6,7,7,7,6,7,7,86.68900013,49,male,Venezuela (República Bolivariana de),Bachelor's degree,2
306,14,14,14,14,14,2,7,7,1,1,7,7,7,7,7,7,7,7,45.19799995,63,female,Argentina,Associate's degree,1
309,13,12,13,13,12,10,7,6,5,5,6,7,7,6,5,7,6,6,77.44700003,43,NA,Argentina,High School diploma,1
312,14,14,14,14,14,2,7,7,1,1,7,7,7,7,7,7,7,7,94.8039999,60,female,Colombia,Bachelor's degree,5
313,12,4,13,13,8,11,6,7,5,6,6,7,6,6,6,2,2,2,125.27,NA,NA,,,5
314,8,2,11,10,12,9,3,7,3,6,6,5,4,4,5,7,1,1,58.38100004,37,NA,Chile,Technical or vocational training,NA
317,7,7,12,14,13,8,7,7,4,4,6,6,4,3,7,6,4,3,83.95100021,NA,NA,,,NA
319,14,14,14,14,14,2,7,7,1,1,7,7,7,7,7,7,7,7,82.34900022,NA,male,Colombia,Professional degree,NA
320,14,13,14,14,13,14,7,7,7,7,7,7,7,7,6,7,6,7,63.79799986,70,female,Argentina,Bachelor's degree,NA
324,14,14,14,14,10,14,7,7,7,7,7,7,7,7,5,5,7,7,60.32500029,65,male,Argentina,High School diploma,1
325,14,12,11,14,11,9,7,7,3,6,6,5,7,7,4,7,6,6,45.04699993,46,male,Venezuela (República Bolivariana de),High School diploma,7
327,14,14,14,11,13,7,6,5,6,1,7,7,7,7,7,6,7,7,52.28199983,37,female,,High School diploma,1
329,13,8,14,14,7,13,7,7,7,6,7,7,7,6,4,3,3,5,63.81599998,NA,NA,,,NA
331,13,10,14,11,10,12,5,6,6,6,7,7,7,6,5,5,5,5,64.17800021,NA,female,Chile,,1
332,14,8,14,11,9,11,4,7,7,4,7,7,7,7,5,4,4,4,73.79299974,NA,NA,,,NA
333,14,14,14,13,8,11,7,6,7,4,7,7,7,7,4,4,7,7,49.49399996,54,female,Uruguay,Bachelor's degree,NA
336,14,14,14,14,14,13,7,7,7,6,7,7,7,7,7,7,7,7,38.90700006,NA,NA,,,NA
337,14,14,14,14,11,5,7,7,4,1,7,7,7,7,4,7,7,7,87.16299987,66,male,Honduras,Bachelor's degree,NA
338,14,10,14,13,12,14,6,7,7,7,7,7,7,7,6,6,5,5,80.32399988,72,other,Afganistán,Bachelor's degree,NA
342,13,10,7,11,9,6,5,6,3,3,3,4,6,7,6,3,5,5,106.9329998,NA,NA,,,NA
343,12,11,10,14,3,2,7,7,1,1,4,6,6,6,2,1,5,6,44.70499992,69,NA,Uruguay,Professional degree,1
344,13,12,13,13,14,12,6,7,6,6,6,7,7,6,7,7,7,5,41.57799983,58,male,Venezuela (República Bolivariana de),High School diploma,1
345,14,10,14,14,14,14,7,7,7,7,7,7,7,7,7,7,3,7,91.46800017,67,male,Argentina,High School diploma,1
347,11,8,7,10,8,8,5,5,3,5,4,3,5,6,4,4,4,4,35.16499996,18,male,Nicaragua,High School diploma,7
348,14,14,14,12,14,2,5,7,1,1,7,7,7,7,7,7,7,7,93.59000015,65,NA,Bolivia (Estado Plurinacional de),Bachelor's degree,1
354,11,9,12,13,13,2,7,6,1,1,6,6,6,5,7,6,4,5,112.405,47,female,Venezuela (República Bolivariana de),High School diploma,7
357,14,4,14,14,10,14,7,7,7,7,7,7,7,7,5,5,3,1,84.22300005,60,female,El Salvador,Bachelor's degree,7
358,14,12,12,12,13,10,6,6,6,4,6,6,7,7,6,7,6,6,52.57300019,72,NA,Argentina,Bachelor's degree,5
359,12,9,11,11,10,8,6,5,4,4,6,5,6,6,5,5,4,5,80.47399998,63,NA,Argentina,Technical or vocational training,4
360,14,14,13,12,12,3,6,6,2,1,7,6,7,7,6,6,7,7,118.6800001,66,male,,,NA
361,14,14,12,13,13,2,6,7,1,1,6,6,7,7,6,7,7,7,119.484,24,male,,High School diploma,NA
362,12,14,12,11,12,9,4,7,4,5,7,5,7,5,5,7,7,7,123.5100002,18,female,Venezuela (República Bolivariana de),High School diploma,5
363,12,9,13,12,12,11,6,6,6,5,6,7,6,6,6,6,4,5,91.68199992,25,NA,Bolivia (Estado Plurinacional de),Associate's degree,NA
364,13,4,14,13,11,12,6,7,7,5,7,7,6,7,4,7,3,1,44.66400003,50,female,Argentina,Associate's degree,1
365,14,14,14,14,6,14,7,7,7,7,7,7,7,7,3,3,7,7,57.56599998,46,male,Argentina,Associate's degree,5
366,13,14,13,12,12,8,6,6,3,5,7,6,7,6,6,6,7,7,120.8600001,47,male,Colombia,High School diploma,2
368,11,10,14,13,14,4,6,7,3,1,7,7,6,5,7,7,5,5,74.28500009,43,female,Argentina,High School diploma,1
369,14,13,14,14,11,13,7,7,7,6,7,7,7,7,6,5,7,6,81.99199986,71,NA,Argentina,,NA
371,13,10,9,11,13,8,4,7,4,4,5,4,7,6,7,6,5,5,68.75099993,45,female,Argentina,High School diploma,1
372,14,14,12,13,14,5,6,7,4,1,7,5,7,7,7,7,7,7,116.7050002,NA,NA,,,NA
373,14,14,14,14,10,9,7,7,6,3,7,7,7,7,5,5,7,7,42.56099987,25,female,Venezuela (República Bolivariana de),High School diploma,1
374,14,13,12,13,13,13,6,7,6,7,6,6,7,7,6,7,7,6,110.401,68,female,,,4
376,8,8,8,7,8,7,3,4,3,4,4,4,4,4,4,4,4,4,69.28200006,72,female,Argentina,,2
377,9,12,14,13,14,12,6,7,6,6,7,7,6,3,7,7,6,6,128.066,54,female,Venezuela (República Bolivariana de),Professional degree,1
378,14,14,13,13,8,13,7,6,7,6,6,7,7,7,4,4,7,7,62.44700003,60,male,Argentina,Professional degree,1
379,13,12,6,12,9,13,6,6,6,7,4,2,7,6,7,2,6,6,88.36899996,NA,NA,,,NA
380,14,12,14,14,12,12,7,7,5,7,7,7,7,7,6,6,6,6,78.31299973,67,male,,,NA
382,14,14,14,14,14,11,7,7,4,7,7,7,7,7,7,7,7,7,101.402,47,NA,Venezuela (República Bolivariana de),Master's degree,1
383,14,13,8,12,4,13,6,6,7,6,2,6,7,7,2,2,7,6,54.87700009,NA,NA,,,NA
384,12,12,10,12,12,8,5,7,5,3,3,7,7,5,5,7,5,7,68.22900009,53,female,,High School diploma,NA
385,14,14,14,14,14,7,7,7,6,1,7,7,7,7,7,7,7,7,55.26599979,65,female,Colombia,Technical or vocational training,NA
386,11,14,10,11,12,7,4,7,1,6,6,4,7,4,6,6,7,7,105.4000001,45,female,Venezuela (República Bolivariana de),Bachelor's degree,3
387,10,8,14,13,4,7,7,6,6,1,7,7,6,4,3,1,2,6,53.27899981,22,female,Uruguay,High School diploma,3
389,10,10,14,14,14,7,7,7,6,1,7,7,5,5,7,7,5,5,38.60599995,18,male,México,High School diploma,7
391,13,6,12,10,10,4,4,6,1,3,6,6,6,7,5,5,3,3,102.4829998,59,female,Argentina,,4
393,13,12,7,13,5,6,6,7,4,2,3,4,6,7,4,1,6,6,110.1630001,55,female,República Dominicana,Bachelor's degree,1
395,13,2,13,14,14,10,7,7,6,4,6,7,6,7,7,7,1,1,54.15600014,51,female,Bolivia (Estado Plurinacional de),Bachelor's degree,7
396,14,10,14,14,11,11,7,7,7,4,7,7,7,7,5,6,5,5,126.9260001,70,female,Argentina,Technical or vocational training,5
399,13,8,14,14,14,4,7,7,1,3,7,7,7,6,7,7,4,4,89.23300004,NA,NA,,,NA
400,10,11,12,14,12,12,7,7,7,5,7,5,5,5,6,6,6,5,54.71800017,49,male,Argentina,Bachelor's degree,3
401,11,7,7,9,10,8,5,4,5,3,3,4,6,5,5,5,3,4,65.92000008,50,NA,Argentina,Professional degree,2
403,14,8,14,14,14,14,7,7,7,7,7,7,7,7,7,7,1,7,48.40300012,NA,NA,,,NA
404,14,14,14,14,5,2,7,7,1,1,7,7,7,7,4,1,7,7,60.92900014,64,NA,,Technical or vocational training,NA
405,7,8,10,11,9,8,5,6,3,5,6,4,6,1,5,4,4,4,73.04500008,87,NA,Argentina,High School diploma,NA
407,9,8,10,14,14,2,7,7,1,1,5,5,4,5,7,7,4,4,49.57099986,35,male,República Dominicana,High School diploma,2
408,13,12,12,12,8,7,6,6,5,2,6,6,6,7,5,3,6,6,66.8670001,75,female,,,5
409,14,14,14,10,5,4,5,5,3,1,7,7,7,7,4,1,7,7,54.5999999,26,NA,El Salvador,Doctorate,7
411,6,6,7,14,12,2,7,7,1,1,2,5,3,3,6,6,3,3,59.55999994,NA,NA,,,NA
413,13,13,10,11,7,9,5,6,4,5,6,4,7,6,3,4,7,6,107.7530003,38,female,Honduras,,NA
414,14,14,14,14,14,4,7,7,3,1,7,7,7,7,7,7,7,7,36.73699999,58,NA,Argentina,Technical or vocational training,7
415,14,14,14,14,7,4,7,7,3,1,7,7,7,7,4,3,7,7,60.61299992,56,male,Colombia,High School diploma,1
417,14,14,13,14,13,12,7,7,5,7,7,6,7,7,6,7,7,7,110.4430003,48,NA,Argentina,High School diploma,3
419,13,14,12,14,14,5,7,7,4,1,6,6,7,6,7,7,7,7,70.50600004,42,male,Venezuela (República Bolivariana de),Bachelor's degree,1
420,13,12,12,12,10,9,6,6,5,4,6,6,7,6,4,6,6,6,36.3599999,47,male,Venezuela (República Bolivariana de),Technical or vocational training,1
421,11,10,14,14,13,3,7,7,1,2,7,7,6,5,7,6,4,6,75.82000017,30,female,Venezuela (República Bolivariana de),High School diploma,1
422,12,10,13,10,13,10,5,5,5,5,7,6,6,6,7,6,5,5,113.635,33,female,Venezuela (República Bolivariana de),High School diploma,2
423,14,14,4,12,10,4,5,7,2,2,3,1,7,7,5,5,7,7,80.44099998,60,female,Colombia,Bachelor's degree,1
424,14,9,14,3,5,2,1,2,1,1,7,7,7,7,4,1,5,4,75.0940001,70,female,Argentina,,7
425,14,10,14,14,14,14,7,7,7,7,7,7,7,7,7,7,5,5,53.56599998,50,female,Argentina,Technical or vocational training,3
426,14,14,8,14,14,2,7,7,1,1,7,1,7,7,7,7,7,7,73.02299976,NA,NA,,,NA
431,13,7,14,13,14,6,6,7,1,5,7,7,7,6,7,7,4,3,117.02,NA,NA,,,NA
433,14,5,11,14,14,2,7,7,1,1,4,7,7,7,7,7,4,1,107.2490001,NA,NA,,,NA
434,14,12,14,7,11,5,3,4,4,1,7,7,7,7,4,7,6,6,86.88100004,44,female,Argentina,Professional degree,1
435,13,12,14,13,12,14,6,7,7,7,7,7,7,6,6,6,6,6,31.09399986,26,NA,Bolivia (Estado Plurinacional de),Bachelor's degree,3
438,10,10,9,9,10,7,4,5,1,6,6,3,5,5,5,5,5,5,71.87100005,64,male,Costa Rica,Technical or vocational training,NA
439,8,10,11,10,12,10,5,5,5,5,6,5,5,3,7,5,5,5,36.40499997,45,NA,Bolivia (Estado Plurinacional de),Bachelor's degree,2
440,14,13,13,13,11,6,6,7,1,5,6,7,7,7,5,6,6,7,105.6719999,53,female,Argentina,Technical or vocational training,2
442,14,14,14,14,14,2,7,7,1,1,7,7,7,7,7,7,7,7,56.50399995,52,female,Venezuela (República Bolivariana de),,NA
443,14,3,14,14,14,12,7,7,6,6,7,7,7,7,7,7,1,2,55.76099992,28,male,Venezuela (República Bolivariana de),High School diploma,NA
444,14,13,14,14,13,10,7,7,5,5,7,7,7,7,6,7,6,7,61.61400008,68,female,Chile,High School diploma,2
448,14,11,12,14,13,2,7,7,1,1,5,7,7,7,6,7,6,5,91.95700002,41,female,,Technical or vocational training,4
449,14,6,13,11,10,5,5,6,3,2,6,7,7,7,4,6,4,2,93.48900008,19,male,Nicaragua,High School diploma,2
450,8,13,14,14,8,2,7,7,1,1,7,7,1,7,3,5,7,6,93.89299989,60,NA,Venezuela (República Bolivariana de),Bachelor's degree,2
451,8,11,5,7,7,11,4,3,6,5,1,4,2,6,6,1,5,6,100.4940002,31,female,Venezuela (República Bolivariana de),,NA
453,14,14,14,14,14,6,7,7,2,4,7,7,7,7,7,7,7,7,59.65100002,49,female,Venezuela (República Bolivariana de),Technical or vocational training,NA
454,14,7,14,14,8,5,7,7,4,1,7,7,7,7,4,4,4,3,122.1259999,NA,NA,,,NA
456,13,14,14,12,13,10,6,6,5,5,7,7,7,6,7,6,7,7,68.64199996,74,female,Uruguay,High School diploma,1
461,14,10,14,14,14,10,7,7,4,6,7,7,7,7,7,7,5,5,61.84800005,41,NA,Argentina,High School diploma,1
462,14,12,13,12,9,10,6,6,4,6,6,7,7,7,5,4,6,6,58.59899998,71,male,Argentina,Professional degree,1
463,14,14,11,14,6,8,7,7,4,4,4,7,7,7,5,1,7,7,46.36500025,NA,NA,,,NA
465,14,14,14,14,13,9,7,7,6,3,7,7,7,7,6,7,7,7,53.66300011,60,female,Colombia,,1
466,13,12,12,13,13,6,6,7,5,1,6,6,7,6,6,7,6,6,64.09699988,40,male,Bolivia (Estado Plurinacional de),Bachelor's degree,2
467,14,14,14,14,14,6,7,7,5,1,7,7,7,7,7,7,7,7,71.227,22,female,Venezuela (República Bolivariana de),High School diploma,1
468,14,14,8,12,14,6,5,7,5,1,1,7,7,7,7,7,7,7,70.19500017,29,male,Venezuela (República Bolivariana de),High School diploma,3
469,14,11,14,10,14,8,5,5,6,2,7,7,7,7,7,7,6,5,51.77600002,45,NA,Venezuela (República Bolivariana de),Professional degree,3
471,14,14,14,14,14,2,7,7,1,1,7,7,7,7,7,7,7,7,74.9940002,54,male,Venezuela (República Bolivariana de),High School diploma,7
472,14,8,14,14,14,11,7,7,7,4,7,7,7,7,7,7,4,4,59.85500002,26,male,Colombia,High School diploma,7
473,14,14,14,14,13,13,7,7,7,6,7,7,7,7,6,7,7,7,137.9729998,53,female,Argentina,Professional degree,5
474,12,12,14,14,14,14,7,7,7,7,7,7,7,5,7,7,6,6,45.30400014,40,NA,Uruguay,Professional degree,5
476,14,13,14,13,11,3,6,7,1,2,7,7,7,7,6,5,7,6,58.6730001,60,female,Chile,Technical or vocational training,5
481,14,13,14,14,14,13,7,7,6,7,7,7,7,7,7,7,7,6,48.98899984,22,male,Venezuela (República Bolivariana de),High School diploma,3
482,12,11,14,11,7,7,6,5,3,4,7,7,6,6,4,3,5,6,56.24500012,21,female,Honduras,High School diploma,1
483,12,10,13,12,9,5,5,7,2,3,6,7,6,6,6,3,4,6,94.99099994,65,male,Bolivia (Estado Plurinacional de),Bachelor's degree,1
484,14,14,14,14,14,2,7,7,1,1,7,7,7,7,7,7,7,7,54.95000005,40,female,Nicaragua,Bachelor's degree,1
485,12,14,14,13,14,6,6,7,5,1,7,7,7,5,7,7,7,7,67.74600005,29,female,Bolivia (Estado Plurinacional de),Bachelor's degree,NA
486,14,12,10,8,6,4,4,4,2,2,5,5,7,7,3,3,6,6,95.09299994,22,female,República Dominicana,High School diploma,3
492,14,14,14,14,12,8,7,7,4,4,7,7,7,7,7,5,7,7,140.4879999,27,male,Bolivia (Estado Plurinacional de),High School diploma,1
495,12,5,12,14,11,4,7,7,1,3,6,6,6,6,5,6,3,2,76.27400017,55,female,Argentina,High School diploma,1
496,11,10,12,13,10,5,7,6,4,1,6,6,6,5,6,4,5,5,77.45499992,55,male,Venezuela (República Bolivariana de),Technical or vocational training,NA
504,11,14,12,13,12,6,6,7,4,2,6,6,7,4,5,7,7,7,65.31900001,39,female,Venezuela (República Bolivariana de),Technical or vocational training,1
508,13,12,14,12,13,5,6,6,2,3,7,7,6,7,6,7,6,6,83.78299999,44,female,Nicaragua,Bachelor's degree,2
510,11,9,12,11,14,13,5,6,7,6,6,6,6,5,7,7,5,4,64.73699999,24,female,Bolivia (Estado Plurinacional de),High School diploma,1
511,12,9,12,12,10,7,6,6,4,3,6,6,6,6,5,5,4,5,91.65799999,62,female,Venezuela (República Bolivariana de),High School diploma,3
518,14,14,14,14,14,2,7,7,1,1,7,7,7,7,7,7,7,7,74.34599996,37,female,Venezuela (República Bolivariana de),Technical or vocational training,1
522,14,13,14,12,12,2,5,7,1,1,7,7,7,7,5,7,6,7,65.29199982,20,female,Venezuela (República Bolivariana de),High School diploma,1
524,14,13,14,11,9,9,5,6,5,4,7,7,7,7,5,4,6,7,75.35800028,65,female,Venezuela (República Bolivariana de),High School diploma,5
527,12,11,9,11,10,6,5,6,3,3,5,4,6,6,6,4,6,5,57.09000015,61,male,Argentina,Professional degree,NA
528,14,14,14,14,14,2,7,7,1,1,7,7,7,7,7,7,7,7,52.21599984,36,female,Venezuela (República Bolivariana de),Professional degree,3
529,14,11,10,6,4,2,3,3,1,1,5,5,7,7,2,2,6,5,72.38999987,19,male,República Dominicana,High School diploma,5
535,14,14,12,12,14,8,6,6,4,4,6,6,7,7,7,7,7,7,49.44199991,20,female,Guatemala,High School diploma,1
536,12,11,12,12,12,9,6,6,3,6,6,6,6,6,6,6,5,6,48.77699995,33,female,Colombia,High School diploma,1
537,14,14,10,13,14,4,6,7,1,3,7,3,7,7,7,7,7,7,65.7559998,64,female,Nicaragua,High School diploma,1
538,11,8,12,14,11,5,7,7,2,3,6,6,6,5,5,6,4,4,80.13199997,22,female,Bolivia (Estado Plurinacional de),Technical or vocational training,1
539,11,12,14,12,12,2,5,7,1,1,7,7,6,5,6,6,6,6,103.6999998,18,female,Bolivia (Estado Plurinacional de),Technical or vocational training,1
540,14,6,12,8,8,13,4,4,7,6,5,7,7,7,2,6,3,3,50.15700006,NA,NA,,,NA
542,14,5,14,14,13,13,7,7,7,6,7,7,7,7,7,6,1,4,53.04900002,NA,NA,,,NA
543,12,9,14,11,7,11,5,6,6,5,7,7,6,6,3,4,4,5,63.84099984,39,female,Venezuela (República Bolivariana de),Technical or vocational training,7
547,14,10,12,13,13,11,6,7,5,6,6,6,7,7,7,6,4,6,62.62800002,22,female,Bolivia (Estado Plurinacional de),High School diploma,1
550,14,12,14,14,14,14,7,7,7,7,7,7,7,7,7,7,5,7,58.42000008,58,female,,High School diploma,1
554,13,8,14,12,14,3,5,7,2,1,7,7,7,6,7,7,4,4,80.74499989,21,female,Venezuela (República Bolivariana de),High School diploma,2
557,14,14,13,12,14,6,5,7,4,2,6,7,7,7,7,7,7,7,51.34700012,40,female,Venezuela (República Bolivariana de),Technical or vocational training,1
560,14,12,13,12,11,11,5,7,7,4,6,7,7,7,5,6,5,7,80.29900002,19,female,Venezuela (República Bolivariana de),High School diploma,1
561,11,12,12,12,13,13,5,7,7,6,6,6,6,5,6,7,6,6,36.02399993,20,female,Guatemala,Bachelor's degree,1
563,14,14,14,13,13,7,7,6,5,2,7,7,7,7,7,6,7,7,96.1500001,39,male,Bolivia (Estado Plurinacional de),Bachelor's degree,1
564,10,9,14,13,13,10,6,7,5,5,7,7,6,4,7,6,6,3,51.40200019,25,female,Perú,Bachelor's degree,NA
571,14,14,14,14,14,10,7,7,7,3,7,7,7,7,7,7,7,7,54.35099983,40,female,Nicaragua,Bachelor's degree,1
573,13,11,12,13,9,9,6,7,4,5,6,6,6,7,3,6,6,5,79.78500009,65,female,Venezuela (República Bolivariana de),Master's degree,3
574,6,8,14,13,14,14,6,7,7,7,7,7,4,2,7,7,4,4,60.21300006,27,female,Venezuela (República Bolivariana de),Technical or vocational training,1
575,13,11,14,14,14,5,7,7,4,1,7,7,7,6,7,7,5,6,143.5190001,34,female,Bolivia (Estado Plurinacional de),Technical or vocational training,1
578,13,6,14,13,14,11,6,7,6,5,7,7,7,6,7,7,5,1,54.28299999,22,male,Colombia,High School diploma,1
579,14,12,14,13,12,6,7,6,5,1,7,7,7,7,6,6,5,7,87.546,38,female,Venezuela (República Bolivariana de),Bachelor's degree,1
580,13,13,13,12,14,8,5,7,5,3,6,7,7,6,7,7,7,6,58.80599999,25,female,España,Bachelor's degree,1
582,12,9,11,12,10,7,6,6,4,3,5,6,6,6,5,5,5,4,45.23699999,NA,NA,,,NA
583,11,14,13,14,10,7,7,7,4,3,6,7,5,6,5,5,7,7,51.86100006,24,female,Bolivia (Estado Plurinacional de),Bachelor's degree,1
586,14,14,14,13,12,2,6,7,1,1,7,7,7,7,6,6,7,7,36.73099995,21,female,,,NA
588,10,6,14,11,12,2,4,7,1,1,7,7,6,4,5,7,2,4,43.28399992,25,NA,Guatemala,High School diploma,3
589,13,13,14,14,14,9,7,7,6,3,7,7,7,6,7,7,6,7,64.86199999,NA,NA,,,NA
590,14,14,14,14,14,2,7,7,1,1,7,7,7,7,7,7,7,7,58.704,26,female,Venezuela (República Bolivariana de),,5
592,12,8,12,13,11,10,6,7,6,4,6,6,6,6,5,6,4,4,52.86100006,NA,NA,,,NA
596,12,10,10,11,7,5,4,7,4,1,5,5,7,5,4,3,5,5,48.79699993,20,female,Nicaragua,Bachelor's degree,NA
597,13,14,14,14,14,11,7,7,6,5,7,7,7,6,7,7,7,7,65.65399981,21,male,Venezuela (República Bolivariana de),High School diploma,4
599,11,10,13,9,11,11,4,5,4,7,7,6,7,4,7,4,4,6,65.61899996,25,female,Venezuela (República Bolivariana de),High School diploma,2
600,9,8,14,14,11,10,7,7,6,4,7,7,5,4,4,7,4,4,58.54799986,22,male,Guatemala,High School diploma,7
601,14,14,14,14,10,4,7,7,3,1,7,7,7,7,5,5,7,7,123.4070001,39,male,Venezuela (República Bolivariana de),Technical or vocational training,1
602,12,11,11,12,11,7,6,6,2,5,6,5,7,5,5,6,6,5,109.5649998,36,female,Bolivia (Estado Plurinacional de),Bachelor's degree,3
603,10,2,12,14,10,8,7,7,4,4,5,7,7,3,7,3,1,1,72.06099987,18,female,Bolivia (Estado Plurinacional de),High School diploma,1
604,14,10,14,12,13,8,6,6,4,4,7,7,7,7,7,6,3,7,68.38199997,28,NA,Venezuela (República Bolivariana de),Technical or vocational training,NA
605,13,13,13,14,12,10,7,7,5,5,6,7,7,6,6,6,7,6,52.19499993,60,female,Venezuela (República Bolivariana de),High School diploma,7
606,14,14,14,14,14,2,7,7,1,1,7,7,7,7,7,7,7,7,54.18199992,63,male,Venezuela (República Bolivariana de),Master's degree,2
607,12,12,13,12,9,9,6,6,4,5,6,7,6,6,6,3,6,6,72.27000022,28,male,Brasil,Technical or vocational training,1
609,13,13,13,12,9,12,6,6,6,6,6,7,7,6,2,7,7,6,57.13199997,22,male,Bolivia (Estado Plurinacional de),Bachelor's degree,2
610,14,14,13,12,12,6,5,7,3,3,6,7,7,7,5,7,7,7,74.81099987,47,NA,Venezuela (República Bolivariana de),High School diploma,1
612,12,4,14,13,14,8,6,7,3,5,7,7,7,5,7,7,2,2,80.46299982,20,NA,Bolivia (Estado Plurinacional de),Technical or vocational training,1
614,11,10,10,11,14,10,4,7,6,4,4,6,6,5,7,7,4,6,39.69499993,20,female,Venezuela (República Bolivariana de),High School diploma,NA
616,14,13,14,14,14,14,7,7,7,7,7,7,7,7,7,7,7,6,73.90199995,26,male,Argentina,High School diploma,1
618,9,9,14,10,6,11,5,5,6,5,7,7,5,4,4,2,4,5,64.48000002,71,NA,Argentina,Bachelor's degree,7
619,14,9,12,12,10,10,6,6,6,4,6,6,7,7,6,4,3,6,82.63999987,20,male,Bolivia (Estado Plurinacional de),High School diploma,5
622,13,11,14,14,13,9,7,7,5,4,7,7,7,6,6,7,7,4,54.73600006,29,male,,Technical or vocational training,4
624,13,11,14,13,13,7,6,7,5,2,7,7,7,6,7,6,5,6,41.02800012,NA,NA,,,NA
632,12,9,12,12,11,6,7,5,4,2,7,5,7,5,4,7,4,5,71.43099976,28,male,Venezuela (República Bolivariana de),Technical or vocational training,4
634,13,10,14,12,11,11,6,6,5,6,7,7,6,7,6,5,5,5,64.13599968,26,NA,Nicaragua,Bachelor's degree,2
636,14,14,14,14,14,2,7,7,1,1,7,7,7,7,7,7,7,7,55.39199996,21,female,Venezuela (República Bolivariana de),High School diploma,2
638,9,12,14,14,14,9,7,7,4,5,7,7,4,5,7,7,5,7,44.56599998,21,NA,Bolivia (Estado Plurinacional de),Technical or vocational training,5
640,11,10,13,12,14,4,6,6,2,2,7,6,6,5,7,7,6,4,39.55800009,19,female,Bolivia (Estado Plurinacional de),Professional degree,2
642,12,13,14,13,13,7,6,7,6,1,7,7,6,6,6,7,7,6,65.25,35,male,Bolivia (Estado Plurinacional de),Bachelor's degree,NA
644,10,9,12,9,11,7,4,5,3,4,5,7,5,5,6,5,5,4,37.53900003,24,female,Venezuela (República Bolivariana de),High School diploma,1
645,14,14,14,11,8,7,7,4,4,3,7,7,7,7,4,4,7,7,55.47600007,36,male,Argentina,High School diploma,4
648,14,8,12,14,14,6,7,7,1,5,5,7,7,7,7,7,5,3,109.6750002,32,female,Venezuela (República Bolivariana de),High School diploma,1
650,13,13,12,14,11,9,7,7,7,2,5,7,7,6,4,7,6,7,79.10000014,19,female,Bolivia (Estado Plurinacional de),High School diploma,1
652,10,13,13,14,13,13,7,7,7,6,6,7,7,3,7,6,7,6,49.67600012,19,male,Venezuela (República Bolivariana de),Professional degree,4
655,14,14,14,14,5,2,7,7,1,1,7,7,7,7,4,1,7,7,109.7929997,27,female,Bolivia (Estado Plurinacional de),High School diploma,1
656,14,9,8,11,14,6,6,5,3,3,5,3,7,7,7,7,3,6,113.6330001,23,female,Venezuela (República Bolivariana de),Bachelor's degree,1
657,14,13,14,14,14,5,7,7,1,4,7,7,7,7,7,7,6,7,52.52900028,22,female,Venezuela (República Bolivariana de),High School diploma,1
658,14,12,14,13,14,5,6,7,4,1,7,7,7,7,7,7,6,6,37.921,NA,NA,,,NA
660,13,12,14,13,14,11,7,6,7,4,7,7,7,6,7,7,6,6,44.30599976,19,female,Guatemala,Bachelor's degree,1
661,14,13,7,12,8,4,6,6,1,3,4,3,7,7,5,3,6,7,98.01399994,19,male,El Salvador,High School diploma,2
663,13,12,13,13,14,12,6,7,6,6,7,6,7,6,7,7,6,6,94.41800022,NA,NA,,,NA
664,12,13,14,12,13,12,6,6,6,6,7,7,7,5,7,6,6,7,54.42600012,19,female,Guatemala,High School diploma,2
665,11,11,14,13,13,10,6,7,6,4,7,7,6,5,6,7,6,5,39.46700001,NA,male,Argentina,Master's degree,5
666,14,12,14,12,14,12,6,6,6,6,7,7,7,7,7,7,6,6,80.87900019,20,female,Bolivia (Estado Plurinacional de),High School diploma,1
668,11,11,11,14,11,2,7,7,1,1,4,7,7,4,7,4,7,4,55.69300032,24,male,Venezuela (República Bolivariana de),High School diploma,1
671,14,14,14,11,8,10,5,6,5,5,7,7,7,7,3,5,7,7,96.58800006,30,female,Venezuela (República Bolivariana de),Bachelor's degree,1
672,13,13,14,12,14,4,6,6,3,1,7,7,7,6,7,7,7,6,43.26499987,NA,female,Bolivia (Estado Plurinacional de),High School diploma,3
673,10,12,14,13,11,9,6,7,4,5,7,7,5,5,6,5,6,6,90.37199998,39,female,Argentina,Bachelor's degree,2
676,14,2,14,11,14,14,4,7,7,7,7,7,7,7,7,7,1,1,56.71799994,25,female,Argentina,High School diploma,1
677,11,6,9,11,11,7,6,5,4,3,3,6,5,6,5,6,3,3,39.36800003,22,female,Argentina,High School diploma,3
678,14,13,14,14,13,2,7,7,1,1,7,7,7,7,7,6,6,7,73.76900005,23,female,Nicaragua,Associate's degree,6
682,14,10,14,12,13,7,7,5,1,6,7,7,7,7,7,6,6,4,89.83400011,20,male,Argentina,High School diploma,1
683,10,8,14,13,12,7,6,7,3,4,7,7,6,4,6,6,3,5,71.57999992,28,male,Guatemala,High School diploma,5
685,14,12,13,10,14,6,5,5,2,4,7,6,7,7,7,7,7,5,54.3119998,24,female,Bolivia (Estado Plurinacional de),Associate's degree,4
686,12,9,13,12,12,7,5,7,3,4,7,6,6,6,5,7,5,4,46.69999981,26,female,Argentina,Professional degree,7
687,12,7,14,12,11,5,6,6,2,3,7,7,7,5,6,5,3,4,35.69199991,32,female,Argentina,Professional degree,NA
690,12,13,13,13,13,9,7,6,2,7,7,6,6,6,7,6,7,6,59.01799989,30,NA,Honduras,Bachelor's degree,3
691,14,14,14,14,14,11,7,7,4,7,7,7,7,7,7,7,7,7,128.0089998,22,male,Bolivia (Estado Plurinacional de),High School diploma,1
693,13,13,14,14,14,12,7,7,7,5,7,7,7,6,7,7,7,6,46.02499986,23,female,Venezuela (República Bolivariana de),Professional degree,5
694,10,8,10,11,13,12,4,7,7,5,7,3,6,4,6,7,4,4,39.26400018,20,male,Guatemala,High School diploma,5
695,13,12,14,14,14,13,7,7,7,6,7,7,7,6,7,7,6,6,82.24600029,NA,NA,,,NA
697,13,13,13,13,10,5,6,7,2,3,6,7,7,6,3,7,7,6,51.41400003,21,male,Bolivia (Estado Plurinacional de),High School diploma,3
698,13,13,14,13,14,7,6,7,5,2,7,7,7,6,7,7,6,7,128.8429999,18,female,Bolivia (Estado Plurinacional de),High School diploma,2
700,13,6,13,14,12,6,7,7,3,3,6,7,7,6,7,5,4,2,47.53299999,NA,NA,,,NA
701,13,12,12,13,11,9,6,7,4,5,6,6,7,6,5,6,6,6,105.3099999,18,male,Venezuela (República Bolivariana de),Technical or vocational training,3
702,14,12,14,13,14,14,6,7,7,7,7,7,7,7,7,7,5,7,50.03499985,24,male,,Technical or vocational training,6
705,14,14,14,14,14,2,7,7,1,1,7,7,7,7,7,7,7,7,66.58500004,22,other,Honduras,High School diploma,5
706,12,12,14,14,13,13,7,7,7,6,7,7,6,6,7,6,6,6,75.76399994,72,male,Argentina,Professional degree,1
709,14,14,14,14,14,11,7,7,7,4,7,7,7,7,7,7,7,7,46.42599988,NA,NA,,,NA
710,14,8,14,14,14,14,7,7,7,7,7,7,7,7,7,7,4,4,83.43499994,24,male,Bolivia (Estado Plurinacional de),High School diploma,4
712,2,4,3,14,12,10,7,7,5,5,1,2,1,1,6,6,2,2,105.4980001,22,male,Ecuador,High School diploma,2
713,8,14,14,14,14,14,7,7,7,7,7,7,7,1,7,7,7,7,68.88500023,29,male,Bolivia (Estado Plurinacional de),High School diploma,1
719,10,11,11,14,14,5,7,7,1,4,7,4,7,3,7,7,7,4,41.07400012,22,female,Nicaragua,Bachelor's degree,1
720,12,9,14,13,12,9,6,7,5,4,7,7,6,6,6,6,4,5,75.27699995,24,male,Venezuela (República Bolivariana de),Bachelor's degree,5
724,6,7,13,8,14,2,3,5,1,1,7,6,2,4,7,7,5,2,45.18100023,50,NA,Chile,Technical or vocational training,3
726,13,11,14,14,11,10,7,7,4,6,7,7,7,6,4,7,6,5,46.13699985,31,male,Argentina,Bachelor's degree,3
727,14,14,14,14,14,2,7,7,1,1,7,7,7,7,7,7,7,7,108.0419998,41,female,Venezuela (República Bolivariana de),Professional degree,NA
731,14,14,14,14,14,8,7,7,4,4,7,7,7,7,7,7,7,7,60.00099993,40,female,,High School diploma,1
732,12,12,14,13,13,14,6,7,7,7,7,7,6,6,7,6,6,6,87.97300005,NA,NA,,,NA
733,14,2,11,8,13,10,4,4,3,7,6,5,7,7,6,7,1,1,59.70499992,19,NA,Honduras,Technical or vocational training,6
734,8,12,9,11,10,9,5,6,7,2,6,3,2,6,4,6,7,5,141.168,48,male,Argentina,Associate's degree,2
735,8,7,14,14,11,2,7,7,1,1,7,7,3,5,4,7,3,4,63.82499981,28,female,Venezuela (República Bolivariana de),Bachelor's degree,4
736,14,8,14,12,8,11,6,6,6,5,7,7,7,7,4,4,4,4,63.19100022,29,female,Nicaragua,Bachelor's degree,3
737,14,6,14,14,14,11,7,7,4,7,7,7,7,7,7,7,2,4,48.95800018,25,female,Bolivia (Estado Plurinacional de),Bachelor's degree,1
741,12,13,13,14,13,13,7,7,7,6,6,7,7,5,7,6,7,6,42.39300013,18,female,Honduras,High School diploma,1
745,13,10,13,13,13,8,6,7,5,3,7,6,7,6,6,7,5,5,65.95100021,23,male,Honduras,High School diploma,5
747,11,9,14,14,10,7,7,7,3,4,7,7,7,4,6,4,4,5,101.8559999,24,male,Argentina,High School diploma,1
748,11,13,13,13,14,7,6,7,4,3,6,7,6,5,7,7,6,7,47.8499999,23,NA,Nicaragua,High School diploma,1
751,11,10,10,10,10,9,5,5,4,5,5,5,6,5,5,5,5,5,66.42599988,23,male,Bolivia (Estado Plurinacional de),Technical or vocational training,1
752,13,10,13,11,12,6,5,6,3,3,7,6,6,7,7,5,6,4,77.69299984,29,male,Bolivia (Estado Plurinacional de),Bachelor's degree,3
753,14,8,14,14,7,4,7,7,3,1,7,7,7,7,4,3,4,4,57.55800009,28,female,Venezuela (República Bolivariana de),High School diploma,1
754,14,14,14,14,13,2,7,7,1,1,7,7,7,7,7,6,7,7,46.92599988,19,female,Nicaragua,High School diploma,1
755,12,14,14,14,14,2,7,7,1,1,7,7,6,6,7,7,7,7,82.74399996,NA,NA,,,NA
756,9,12,14,13,10,5,7,6,4,1,7,7,5,4,5,5,5,7,93.64100003,23,male,Nicaragua,High School diploma,1
760,14,14,14,14,2,14,7,7,7,7,7,7,7,7,1,1,7,7,53.81099987,18,NA,Colombia,Professional degree,3
762,14,12,14,14,14,4,7,7,3,1,7,7,7,7,7,7,7,5,71.05400014,30,NA,Argentina,High School diploma,1
764,2,2,6,12,10,14,6,6,7,7,3,3,1,1,5,5,1,1,80.3599999,NA,NA,,,NA
765,2,3,6,12,10,14,6,6,7,7,3,3,1,1,5,5,2,1,59.61500025,NA,NA,,,NA
766,6,2,10,14,4,12,7,7,6,6,5,5,3,3,2,2,1,1,61.40799999,NA,NA,,,NA
770,8,7,10,13,14,8,6,7,6,2,5,5,4,4,7,7,3,4,56.14399981,18,male,Nicaragua,High School diploma,5
771,14,4,14,14,10,3,7,7,1,2,7,7,7,7,3,7,3,1,55.57400012,19,NA,Venezuela (República Bolivariana de),Professional degree,1
774,12,10,14,13,10,9,7,6,6,3,7,7,7,5,3,7,5,5,49.23500013,21,male,Argentina,Associate's degree,1
775,12,12,14,14,14,14,7,7,7,7,7,7,7,5,7,7,7,5,54.44400001,18,female,Venezuela (República Bolivariana de),Technical or vocational training,1
776,13,13,14,14,14,14,7,7,7,7,7,7,7,6,7,7,7,6,66.42799997,18,female,Honduras,Bachelor's degree,1
777,14,14,14,14,14,7,7,7,4,3,7,7,7,7,7,7,7,7,86.273,21,male,El Salvador,High School diploma,7
779,11,8,14,14,13,5,7,7,1,4,7,7,7,4,7,6,4,4,57.38899994,23,NA,Nicaragua,Bachelor's degree,4
780,10,10,9,9,13,8,3,6,4,4,4,5,5,5,7,6,6,4,56.13199997,NA,NA,,,NA
782,14,8,11,14,11,3,7,7,2,1,4,7,7,7,4,7,4,4,76.53700018,NA,NA,,,NA
786,13,14,14,13,13,11,7,6,7,4,7,7,7,6,7,6,7,7,59.61000013,NA,NA,,,NA
787,14,13,13,14,12,5,7,7,3,2,7,6,7,7,5,7,7,6,41.13700008,20,male,Venezuela (República Bolivariana de),Technical or vocational training,3
789,12,12,14,14,13,12,7,7,5,7,7,7,6,6,6,7,6,6,95.77300024,23,NA,Venezuela (República Bolivariana de),Professional degree,6
791,13,14,14,12,13,11,6,6,5,6,7,7,7,6,6,7,7,7,70.47300005,20,male,Venezuela (República Bolivariana de),High School diploma,1
792,12,13,13,12,9,12,6,6,6,6,6,7,6,6,7,2,7,6,68.51499987,27,NA,Bolivia (Estado Plurinacional de),Technical or vocational training,2
796,14,14,14,12,14,12,5,7,7,5,7,7,7,7,7,7,7,7,79.64499998,32,male,Venezuela (República Bolivariana de),Bachelor's degree,7
799,9,9,11,11,12,10,5,6,5,5,5,6,5,4,6,6,4,5,84.1880002,21,female,Venezuela (República Bolivariana de),High School diploma,1
800,14,14,14,13,14,8,6,7,4,4,7,7,7,7,7,7,7,7,110.595,28,male,Bolivia (Estado Plurinacional de),Bachelor's degree,1
801,12,12,12,11,12,9,5,6,7,2,6,6,6,6,6,6,6,6,31.64299989,36,NA,Venezuela (República Bolivariana de),High School diploma,1
803,14,11,12,14,14,9,7,7,5,4,5,7,7,7,7,7,6,5,77.5150001,18,male,Nicaragua,Technical or vocational training,1
804,4,2,2,14,10,12,7,7,6,6,1,1,2,2,5,5,1,1,51.05100012,NA,NA,,,NA
805,10,14,6,2,12,12,1,1,6,6,3,3,5,5,6,6,7,7,52.70799971,NA,NA,,,NA
806,6,2,10,14,4,12,7,7,6,6,5,5,3,3,2,2,1,1,58.70799994,NA,NA,,,NA
810,14,14,14,14,14,2,7,7,1,1,7,7,7,7,7,7,7,7,103.1960001,20,male,Bolivia (Estado Plurinacional de),High School diploma,7
811,14,13,14,14,13,9,7,7,5,4,7,7,7,7,6,7,6,7,126.138,22,female,Nicaragua,Professional degree,3
812,14,2,14,13,14,9,6,7,5,4,7,7,7,7,7,7,1,1,68.03999996,18,female,Venezuela (República Bolivariana de),High School diploma,NA
813,14,14,11,14,14,2,7,7,1,1,4,7,7,7,7,7,7,7,61.66799998,20,male,Venezuela (República Bolivariana de),High School diploma,3
814,8,9,14,14,14,8,7,7,2,6,7,7,6,2,7,7,6,3,52.11199999,19,female,Nicaragua,High School diploma,3
815,8,10,13,13,14,11,6,7,4,7,6,7,5,3,7,7,6,4,52.83100009,21,female,Nicaragua,Professional degree,NA
816,14,13,14,14,14,11,7,7,7,4,7,7,7,7,7,7,7,6,41.66599989,19,male,Bolivia (Estado Plurinacional de),High School diploma,1
819,14,14,14,14,14,2,7,7,1,1,7,7,7,7,7,7,7,7,55.04400015,NA,NA,,,NA
822,13,7,14,12,9,10,5,7,5,5,7,7,7,6,3,6,4,3,127.3509998,30,female,Venezuela (República Bolivariana de),High School diploma,NA
825,10,11,12,12,12,8,6,6,6,2,6,6,5,5,6,6,5,6,123.2559998,19,female,Perú,High School diploma,3
826,14,14,12,13,14,2,6,7,1,1,7,5,7,7,7,7,7,7,35.13199997,20,female,Colombia,Technical or vocational training,4
827,4,2,4,12,10,14,6,6,7,7,2,2,2,2,5,5,1,1,60.92000008,21,male,,,NA
828,2,2,6,14,10,13,7,7,6,7,3,3,1,1,5,5,1,1,52.2809999,18,NA,,,5
829,14,10,14,14,14,10,7,7,6,4,7,7,7,7,7,7,4,6,82.19700003,22,female,Colombia,Technical or vocational training,1
830,12,7,11,12,13,8,6,6,4,4,5,6,6,6,6,7,4,3,50.12899995,NA,female,Venezuela (República Bolivariana de),High School diploma,3
832,13,8,14,14,14,8,7,7,3,5,7,7,7,6,7,7,3,5,56.17700005,26,female,Venezuela (República Bolivariana de),Bachelor's degree,7
833,14,6,12,7,11,13,3,4,6,7,7,5,7,7,7,4,3,3,62.546,40,female,Venezuela (República Bolivariana de),High School diploma,1
834,10,9,14,12,8,3,5,7,2,1,7,7,6,4,3,5,6,3,73.53700018,18,male,Nicaragua,High School diploma,7
836,13,11,14,14,13,14,7,7,7,7,7,7,7,6,7,6,4,7,139.7460001,24,female,Venezuela (República Bolivariana de),Technical or vocational training,5
837,14,11,12,10,12,3,3,7,2,1,5,7,7,7,6,6,6,5,65.73399997,25,female,Honduras,Bachelor's degree,3
839,14,14,14,13,14,11,6,7,4,7,7,7,7,7,7,7,7,7,42.96499968,19,female,Nicaragua,High School diploma,NA
840,14,9,14,11,14,11,4,7,7,4,7,7,7,7,7,7,4,5,108.7529998,23,female,Venezuela (República Bolivariana de),Bachelor's degree,2
841,13,12,13,11,13,3,4,7,2,1,7,6,7,6,6,7,6,6,51.18500018,18,male,Nicaragua,Technical or vocational training,2
842,8,6,14,11,10,9,7,4,5,4,7,7,5,3,4,6,3,3,134.6830001,23,male,Bolivia (Estado Plurinacional de),High School diploma,4
843,14,13,13,14,12,6,7,7,4,2,6,7,7,7,6,6,7,6,109.529,25,female,Nicaragua,High School diploma,2
844,13,12,13,14,13,12,7,7,6,6,6,7,7,6,6,7,5,7,56.11100006,21,other,Honduras,High School diploma,7
847,10,10,13,9,11,7,4,5,3,4,7,6,5,5,4,7,5,5,69.23000002,21,female,Venezuela (República Bolivariana de),High School diploma,1
849,14,12,14,14,14,12,7,7,6,6,7,7,7,7,7,7,6,6,45.46000004,26,NA,Bolivia (Estado Plurinacional de),High School diploma,1
850,8,12,14,12,14,2,6,6,1,1,7,7,6,2,7,7,6,6,65.40799999,20,male,Bolivia (Estado Plurinacional de),High School diploma,4
851,13,11,13,14,10,5,7,7,1,4,6,7,7,6,5,5,6,5,46.05699992,24,female,Colombia,High School diploma,2
852,14,14,14,14,14,2,7,7,1,1,7,7,7,7,7,7,7,7,45.55000019,20,male,Venezuela (República Bolivariana de),High School diploma,1
853,13,11,13,14,12,10,7,7,6,4,7,6,6,7,6,6,4,7,111.5869999,25,female,Venezuela (República Bolivariana de),Bachelor's degree,1
854,13,13,14,13,14,14,6,7,7,7,7,7,7,6,7,7,7,6,90.80400014,25,male,Bolivia (Estado Plurinacional de),High School diploma,3
855,10,9,13,13,7,4,6,7,1,3,6,7,5,5,3,4,5,4,82.82599974,19,female,Venezuela (República Bolivariana de),High School diploma,1
857,11,8,12,10,14,10,5,5,3,7,5,7,7,4,7,7,4,4,61.00699997,20,female,Venezuela (República Bolivariana de),High School diploma,2
859,14,12,14,14,11,6,7,7,4,2,7,7,7,7,4,7,5,7,45.66900015,21,male,Venezuela (República Bolivariana de),High School diploma,7
860,14,12,12,12,12,3,5,7,1,2,6,6,7,7,6,6,6,6,47.7249999,25,NA,Bolivia (Estado Plurinacional de),Bachelor's degree,2
861,14,14,13,14,8,2,7,7,1,1,6,7,7,7,4,4,7,7,36.45700002,20,female,Nicaragua,Bachelor's degree,1
862,12,13,12,12,12,7,6,6,5,2,6,6,6,6,6,6,7,6,117.724,20,female,Venezuela (República Bolivariana de),Technical or vocational training,1
864,12,14,14,13,11,3,6,7,1,2,7,7,5,7,7,4,7,7,88.84099984,18,female,Venezuela (República Bolivariana de),High School diploma,1
865,14,12,14,13,12,4,6,7,2,2,7,7,7,7,6,6,6,6,121.1570001,33,male,Venezuela (República Bolivariana de),Bachelor's degree,1
867,14,14,10,11,14,2,4,7,1,1,6,4,7,7,7,7,7,7,72.49900007,31,NA,Venezuela (República Bolivariana de),Professional degree,1
868,14,14,14,14,14,6,7,7,3,3,7,7,7,7,7,7,7,7,59.80599976,27,female,Venezuela (República Bolivariana de),High School diploma,1
869,14,14,14,14,11,11,7,7,7,4,7,7,7,7,7,4,7,7,47.16300011,31,female,Venezuela (República Bolivariana de),Technical or vocational training,1
870,14,12,14,14,9,3,7,7,2,1,7,7,7,7,5,4,6,6,43.97199988,24,female,Venezuela (República Bolivariana de),Technical or vocational training,1
871,11,7,14,8,8,8,4,4,4,4,7,7,4,7,4,4,4,3,33.99500012,22,male,Belice,Bachelor's degree,2
874,6,2,14,14,10,8,7,7,4,4,7,7,3,3,3,7,1,1,42.68999982,18,female,Nicaragua,High School diploma,1
875,13,12,14,11,11,14,4,7,7,7,7,7,7,6,6,5,7,5,36.90500021,24,female,Nicaragua,High School diploma,1
876,11,7,11,10,13,10,3,7,6,4,6,5,6,5,6,7,3,4,98.0309999,21,female,Honduras,Master's degree,1
877,12,12,14,14,14,10,7,7,7,3,7,7,7,5,7,7,7,5,78.02900028,24,male,Colombia,Technical or vocational training,2
878,9,10,12,13,14,11,6,7,5,6,6,6,5,4,7,7,6,4,57.05599976,19,NA,,,NA
879,12,14,14,14,10,3,7,7,1,2,7,7,7,5,5,5,7,7,51.71199989,23,female,Nicaragua,Professional degree,1
881,14,14,14,14,14,8,7,7,4,4,7,7,7,7,7,7,7,7,54.54400015,24,male,Bolivia (Estado Plurinacional de),Bachelor's degree,2
882,9,9,12,11,14,8,4,7,4,4,6,6,4,5,7,7,5,4,45.59599996,NA,NA,,,NA
883,14,14,14,14,14,2,7,7,1,1,7,7,7,7,7,7,7,7,90.13699985,19,male,Venezuela (República Bolivariana de),High School diploma,3
888,14,8,10,11,14,7,5,6,3,4,6,4,7,7,7,7,4,4,37.67200017,22,female,Venezuela (República Bolivariana de),High School diploma,7
891,13,7,14,10,10,2,3,7,1,1,7,7,7,6,3,7,3,4,119.5159998,20,female,Venezuela (República Bolivariana de),High School diploma,NA
892,13,10,14,14,11,7,7,7,5,2,7,7,7,6,4,7,6,4,68.60299993,26,male,Bolivia (Estado Plurinacional de),Bachelor's degree,1
893,14,14,14,14,14,2,7,7,1,1,7,7,7,7,7,7,7,7,43.1639998,36,NA,Venezuela (República Bolivariana de),Professional degree,3
894,13,13,14,10,13,10,6,4,4,6,7,7,7,6,6,7,7,6,64.96700001,18,female,Bolivia (Estado Plurinacional de),High School diploma,1
897,14,14,14,14,14,2,7,7,1,1,7,7,7,7,7,7,7,7,74.86599994,24,male,Venezuela (República Bolivariana de),High School diploma,1
899,11,5,12,12,10,7,5,7,4,3,6,6,6,5,4,6,3,2,49.3269999,NA,NA,,,NA
900,14,14,12,12,10,7,6,6,3,4,5,7,7,7,5,5,7,7,53.98900008,25,female,Nicaragua,Bachelor's degree,1
901,12,14,10,8,11,7,5,3,2,5,6,4,6,6,6,5,7,7,65.91499996,77,NA,Argentina,,NA
902,12,11,14,14,9,12,7,7,5,7,7,7,7,5,3,6,6,5,70.51999998,18,female,,,NA
903,14,14,11,14,11,2,7,7,1,1,4,7,7,7,7,4,7,7,50.704,18,male,,Technical or vocational training,2
904,11,9,14,13,14,13,6,7,7,6,7,7,6,5,7,7,4,5,91.47400022,37,female,Venezuela (República Bolivariana de),Technical or vocational training,1
905,13,12,14,13,13,12,6,7,6,6,7,7,6,7,7,6,6,6,72.49199986,NA,male,Argentina,High School diploma,3
907,10,12,14,11,11,10,7,4,7,3,7,7,6,4,4,7,5,7,108.6600003,24,female,Bolivia (Estado Plurinacional de),High School diploma,1
908,13,10,14,14,12,7,7,7,3,4,7,7,7,6,5,7,4,6,53.53299999,22,female,Bolivia (Estado Plurinacional de),Technical or vocational training,NA
910,13,13,14,13,13,7,7,6,6,1,7,7,6,7,6,7,7,6,104.55,34,female,Venezuela (República Bolivariana de),Bachelor's degree,1
915,10,9,11,14,13,2,7,7,1,1,4,7,6,4,6,7,5,4,48.86100006,23,male,Venezuela (República Bolivariana de),High School diploma,1
916,14,14,14,14,14,2,7,7,1,1,7,7,7,7,7,7,7,7,117.392,23,male,Venezuela (República Bolivariana de),High School diploma,1
923,13,12,14,14,14,13,7,7,6,7,7,7,7,6,7,7,7,5,47.22699976,18,NA,Venezuela (República Bolivariana de),High School diploma,7
926,14,12,14,14,13,8,7,7,5,3,7,7,7,7,6,7,6,6,37.90899992,28,male,Venezuela (República Bolivariana de),Technical or vocational training,7
927,12,6,14,14,14,14,7,7,7,7,7,7,7,5,7,7,5,1,55.79700017,21,male,Nicaragua,High School diploma,1
929,14,14,14,14,14,11,7,7,5,6,7,7,7,7,7,7,7,7,49.31200027,26,male,Bolivia (Estado Plurinacional de),High School diploma,3
933,13,10,12,13,10,9,6,7,4,5,6,6,6,7,4,6,5,5,59.76499987,42,male,Venezuela (República Bolivariana de),High School diploma,3
934,14,14,14,14,14,10,7,7,5,5,7,7,7,7,7,7,7,7,41.4920001,20,male,Ecuador,High School diploma,7
935,13,9,14,14,12,14,7,7,7,7,7,7,7,6,5,7,4,5,61.20899987,19,NA,Venezuela (República Bolivariana de),Technical or vocational training,4
936,12,6,14,13,14,11,6,7,7,4,7,7,6,6,7,7,3,3,47.81500006,23,female,Guatemala,Technical or vocational training,1
939,4,2,5,10,10,13,7,3,6,7,4,1,2,2,5,5,1,1,52.59499979,20,male,,Bachelor's degree,4
940,3,4,8,11,10,12,7,4,6,6,4,4,1,2,5,5,2,2,50.04699993,NA,NA,,,NA
941,3,2,8,14,10,12,7,7,6,6,4,4,1,2,5,5,1,1,37.16299987,24,male,Argentina,High School diploma,5
942,5,5,8,14,10,12,7,7,6,6,4,4,4,1,5,5,1,4,41.23300004,NA,NA,,,NA
943,2,2,8,10,14,12,5,5,6,6,4,4,1,1,7,7,1,1,32.92700005,20,male,,,NA
944,14,12,14,14,14,14,7,7,7,7,7,7,7,7,7,7,6,6,31.64100003,29,NA,Nicaragua,,6
946,14,13,13,14,11,4,7,7,1,3,7,6,7,7,4,7,6,7,67.82000017,28,male,Colombia,Bachelor's degree,4
947,2,2,8,14,10,4,7,7,2,2,4,4,1,1,5,5,1,1,30.55999994,NA,NA,,,NA
949,10,9,13,12,13,2,5,7,1,1,6,7,4,6,7,6,5,4,51.03699994,38,NA,Venezuela (República Bolivariana de),Bachelor's degree,7
951,12,14,14,14,14,12,7,7,6,6,7,7,6,6,7,7,7,7,54.22300005,23,male,Bolivia (Estado Plurinacional de),Bachelor's degree,6
952,13,10,11,12,7,11,5,7,6,5,5,6,7,6,4,3,6,4,46.92700005,20,female,Colombia,High School diploma,2
953,11,12,14,11,14,6,7,4,1,5,7,7,7,4,7,7,7,5,79.78999996,18,NA,Venezuela (República Bolivariana de),Bachelor's degree,1
956,14,13,14,13,14,14,6,7,7,7,7,7,7,7,7,7,7,6,42.89700007,37,female,Venezuela (República Bolivariana de),High School diploma,1
960,14,14,14,13,13,14,6,7,7,7,7,7,7,7,6,7,7,7,87.47200012,23,NA,Bolivia (Estado Plurinacional de),High School diploma,2
961,11,13,13,10,12,8,4,6,4,4,6,7,5,6,6,6,6,7,37.06500006,24,female,Bolivia (Estado Plurinacional de),Technical or vocational training,NA
963,12,9,10,12,12,10,6,6,5,5,3,7,6,6,6,6,3,6,40.62400007,20,male,Australia,High School diploma,2
964,13,12,12,11,12,12,5,6,6,6,6,6,6,7,6,6,6,6,65.19200015,26,male,Guatemala,High School diploma,2
971,14,14,6,14,4,4,7,7,2,2,4,2,7,7,2,2,7,7,57.148,23,male,Bolivia (Estado Plurinacional de),Bachelor's degree,2
977,13,11,13,13,13,6,6,7,2,4,6,7,7,6,6,7,6,5,60.25699997,25,male,,,NA
979,10,6,12,13,11,4,6,7,1,3,6,6,6,4,6,5,3,3,44.52900004,22,NA,Honduras,Doctorate,4
982,9,12,14,14,13,7,7,7,1,6,7,7,5,4,7,6,6,6,55.17000008,21,male,El Salvador,Bachelor's degree,7
986,10,9,11,12,14,12,5,7,7,5,7,4,5,5,7,7,4,5,77.32799983,24,male,Colombia,High School diploma,7
988,14,9,14,14,14,2,7,7,1,1,7,7,7,7,7,7,5,4,127.675,26,female,El Salvador,Bachelor's degree,1
989,10,11,11,10,10,9,5,5,4,5,5,6,5,5,5,5,6,5,113.119,18,female,Bolivia (Estado Plurinacional de),High School diploma,2
990,13,11,12,14,13,8,7,7,5,3,7,5,7,6,6,7,6,5,49.42299986,23,male,Bolivia (Estado Plurinacional de),Bachelor's degree,4
992,12,13,14,13,14,13,6,7,6,7,7,7,6,6,7,7,6,7,77.56800008,23,male,Bolivia (Estado Plurinacional de),High School diploma,5
996,14,14,14,14,14,2,7,7,1,1,7,7,7,7,7,7,7,7,41.33100009,24,male,Bolivia (Estado Plurinacional de),Technical or vocational training,3
997,14,13,14,14,9,5,7,7,4,1,7,7,7,7,5,4,6,7,111.7390001,NA,NA,,,NA
998,14,14,14,14,14,2,7,7,1,1,7,7,7,7,7,7,7,7,75.37200022,52,male,Bolivia (Estado Plurinacional de),High School diploma,NA
999,13,14,14,14,14,11,7,7,5,6,7,7,7,6,7,7,7,7,75.7670002,20,female,Bolivia (Estado Plurinacional de),Bachelor's degree,3
1000,14,14,14,14,14,12,7,7,7,5,7,7,7,7,7,7,7,7,115.4070001,25,male,Bolivia (Estado Plurinacional de),Bachelor's degree,5
1002,13,8,12,9,14,7,5,4,3,4,7,5,6,7,7,7,3,5,61.69199991,25,male,Bolivia (Estado Plurinacional de),High School diploma,4
1006,10,9,13,12,10,6,6,6,3,3,6,7,5,5,4,6,5,4,106.1240001,23,female,Honduras,Bachelor's degree,2
1007,10,9,14,11,11,8,5,6,4,4,7,7,5,5,4,7,5,4,36.08300018,NA,NA,,,NA
1011,9,9,14,14,8,4,7,7,2,2,7,7,7,2,2,6,2,7,70.67500019,28,NA,Nicaragua,High School diploma,1
1012,14,14,14,14,14,12,7,7,7,5,7,7,7,7,7,7,7,7,47.42499995,34,female,Venezuela (República Bolivariana de),Professional degree,7
1014,11,12,13,11,11,11,4,7,5,6,7,6,7,4,4,7,7,5,91.72300005,22,male,Bolivia (Estado Plurinacional de),High School diploma,NA
1017,13,14,14,13,11,10,6,7,5,5,7,7,7,6,5,6,7,7,72.14599991,30,female,Venezuela (República Bolivariana de),Professional degree,2
1022,14,12,14,14,13,2,7,7,1,1,7,7,7,7,6,7,5,7,73.69899988,18,female,Venezuela (República Bolivariana de),Bachelor's degree,2
1026,14,12,14,14,11,13,7,7,6,7,7,7,7,7,7,4,5,7,90.10300016,30,male,Bolivia (Estado Plurinacional de),Technical or vocational training,1
1027,14,14,14,14,14,6,7,7,1,5,7,7,7,7,7,7,7,7,43.93499994,39,NA,Venezuela (República Bolivariana de),Bachelor's degree,7
1029,14,14,13,14,14,10,7,7,6,4,6,7,7,7,7,7,7,7,45.09099984,19,female,Bolivia (Estado Plurinacional de),Technical or vocational training,5
1031,14,11,11,11,12,9,4,7,5,4,4,7,7,7,6,6,6,5,47.49799991,24,male,Bolivia (Estado Plurinacional de),Professional degree,7
1032,13,11,12,9,9,11,3,6,6,5,6,6,7,6,4,5,5,6,51.74300003,65,female,Venezuela (República Bolivariana de),High School diploma,7
1033,11,10,14,14,14,13,7,7,6,7,7,7,6,5,7,7,5,5,60.51300001,20,male,Bolivia (Estado Plurinacional de),High School diploma,1
1038,8,8,14,13,14,14,6,7,7,7,7,7,4,4,7,7,4,4,63.10399985,23,male,Bolivia (Estado Plurinacional de),High School diploma,1
1039,12,12,12,12,12,10,6,6,5,5,6,6,6,6,7,5,6,6,31.93700027,27,male,Bolivia (Estado Plurinacional de),Bachelor's degree,7
1042,12,8,13,14,11,9,7,7,5,4,6,7,5,7,7,4,4,4,51.86300015,49,male,Venezuela (República Bolivariana de),High School diploma,3
1043,14,14,13,12,12,14,5,7,7,7,7,6,7,7,5,7,7,7,71.80200005,NA,male,Venezuela (República Bolivariana de),High School diploma,3
1045,12,14,7,13,13,4,6,7,2,2,2,5,6,6,6,7,7,7,76.32800007,19,male,Nicaragua,Technical or vocational training,4
1046,14,14,14,14,12,11,7,7,5,6,7,7,7,7,7,5,7,7,51.66299987,34,female,Venezuela (República Bolivariana de),Bachelor's degree,1
1047,9,11,14,14,14,6,7,7,2,4,7,7,5,4,7,7,5,6,78.81200004,26,male,Argentina,Bachelor's degree,7
1048,3,6,2,2,4,4,1,1,3,1,1,1,1,2,2,2,3,3,58.89699984,25,male,Bolivia (Estado Plurinacional de),Bachelor's degree,1
1051,14,13,13,12,14,13,5,7,6,7,7,6,7,7,7,7,7,6,85.60000014,23,male,Bolivia (Estado Plurinacional de),Bachelor's degree,5
1052,14,8,14,14,10,8,7,7,4,4,7,7,7,7,6,4,4,4,87.25199986,54,female,,Bachelor's degree,1
1053,11,14,14,12,12,12,6,6,7,5,7,7,5,6,7,5,7,7,88.02099991,20,female,Bolivia (Estado Plurinacional de),Bachelor's degree,1
1054,11,5,14,9,14,13,5,4,7,6,7,7,6,5,7,7,3,2,121.2219999,23,male,Bolivia (Estado Plurinacional de),Bachelor's degree,7
1055,14,13,14,14,14,11,7,7,5,6,7,7,7,7,7,7,7,6,56.01200008,42,female,Nicaragua,Technical or vocational training,1
1056,14,12,13,12,13,10,5,7,5,5,7,6,7,7,6,7,6,6,65.5389998,24,male,Bolivia (Estado Plurinacional de),Bachelor's degree,3
1059,13,13,14,13,14,10,6,7,5,5,7,7,7,6,7,7,7,6,55.54299998,34,NA,Colombia,Bachelor's degree,1
1060,11,5,12,13,11,10,6,7,4,6,7,5,7,4,4,7,1,4,31.20799994,22,NA,Uruguay,High School diploma,3
1061,14,11,14,14,14,14,7,7,7,7,7,7,7,7,7,7,7,4,35.83900023,28,male,Colombia,High School diploma,2
1062,10,7,14,13,12,4,7,6,1,3,7,7,6,4,6,6,3,4,61.14099979,25,female,Bolivia (Estado Plurinacional de),Bachelor's degree,1
1065,14,13,14,13,14,9,6,7,7,2,7,7,7,7,7,7,7,6,65.74699998,28,female,Venezuela (República Bolivariana de),High School diploma,1
1067,14,14,13,14,14,11,7,7,7,4,7,6,7,7,7,7,7,7,33.19200015,23,male,,Technical or vocational training,3
1069,14,6,14,14,14,11,7,7,7,4,7,7,7,7,7,7,3,3,57.26300001,34,male,Venezuela (República Bolivariana de),High School diploma,1
1071,12,10,14,11,8,7,4,7,3,4,7,7,5,7,4,4,5,5,73.89900017,33,female,Venezuela (República Bolivariana de),Associate's degree,NA
1073,12,12,7,12,12,10,6,6,3,7,4,3,6,6,6,6,6,6,39.0619998,49,male,Venezuela (República Bolivariana de),Bachelor's degree,7
1074,13,13,14,14,13,11,7,7,5,6,7,7,6,7,6,7,7,6,55.65299988,31,male,Venezuela (República Bolivariana de),Bachelor's degree,5
1075,14,13,14,14,14,11,7,7,5,6,7,7,7,7,7,7,6,7,46.71199989,20,female,Venezuela (República Bolivariana de),High School diploma,1
1076,10,9,10,8,10,8,4,4,3,5,5,5,5,5,5,5,4,5,82.89700007,41,female,Venezuela (República Bolivariana de),Professional degree,1
1077,11,11,14,14,13,6,7,7,1,5,7,7,7,4,6,7,5,6,53.30699992,26,female,Venezuela (República Bolivariana de),High School diploma,1
1078,14,10,14,14,14,6,7,7,4,2,7,7,7,7,7,7,5,5,37.92299986,20,female,Venezuela (República Bolivariana de),High School diploma,1
1079,2,2,4,14,10,12,7,7,6,6,2,2,1,1,5,5,1,1,51.75199986,32,male,Estados Unidos de América,Bachelor's degree,5
1081,12,10,10,11,12,9,5,6,4,5,5,5,6,6,6,6,5,5,56.09000015,27,female,Venezuela (República Bolivariana de),High School diploma,4
1082,11,8,10,12,11,9,5,7,3,6,5,5,5,6,5,6,5,3,71.75600004,NA,NA,,,NA
1083,13,11,14,12,11,4,6,6,2,2,7,7,7,6,4,7,6,5,52.64900017,26,male,Venezuela (República Bolivariana de),Professional degree,5
1084,14,14,14,14,14,2,7,7,1,1,7,7,7,7,7,7,7,7,48.42399979,33,male,Venezuela (República Bolivariana de),High School diploma,2
1085,12,9,12,12,14,8,5,7,5,3,7,5,6,6,7,7,4,5,108.973,27,female,Bolivia (Estado Plurinacional de),Bachelor's degree,3
1086,11,8,8,11,11,8,7,4,4,4,4,4,4,7,7,4,4,4,96.43500018,65,female,Venezuela (República Bolivariana de),Professional degree,NA
1088,14,6,12,13,12,12,6,7,5,7,6,6,7,7,6,6,3,3,110.1399999,25,female,Venezuela (República Bolivariana de),Technical or vocational training,3
1093,14,14,14,14,14,5,7,7,3,2,7,7,7,7,7,7,7,7,87.89599991,45,female,Colombia,High School diploma,6
1094,12,14,14,12,8,4,5,7,3,1,7,7,7,5,4,4,7,7,50.26099992,23,female,Venezuela (República Bolivariana de),Bachelor's degree,NA
1095,13,14,14,14,14,10,7,7,7,3,7,7,7,6,7,7,7,7,46.26599979,44,female,Venezuela (República Bolivariana de),Master's degree,1
1097,12,12,9,13,13,7,7,6,3,4,4,5,7,5,6,7,7,5,67.79100013,26,male,Bolivia (Estado Plurinacional de),Bachelor's degree,1
1100,14,14,14,14,14,2,7,7,1,1,7,7,7,7,7,7,7,7,141.579,26,female,Bolivia (Estado Plurinacional de),Bachelor's degree,1
1101,10,10,13,13,10,10,7,6,4,6,7,6,6,4,4,6,6,4,72.30500031,54,male,El Salvador,Professional degree,2
1104,10,10,8,9,7,6,5,4,3,3,4,4,6,4,3,4,4,6,51.0710001,20,male,Bolivia (Estado Plurinacional de),Bachelor's degree,1
1107,11,10,12,13,13,13,6,7,7,6,6,6,7,4,7,6,6,4,54.0389998,37,male,Bolivia (Estado Plurinacional de),Technical or vocational training,1
1108,11,8,14,10,10,9,4,6,5,4,7,7,6,5,4,6,4,4,48.86399984,NA,female,Bolivia (Estado Plurinacional de),Technical or vocational training,3
1109,12,12,11,13,12,10,6,7,5,5,7,4,6,6,6,6,6,6,59.59099984,20,male,Bolivia (Estado Plurinacional de),Professional degree,7
1111,6,2,14,13,14,7,6,7,6,1,7,7,5,1,7,7,1,1,71.5940001,19,female,Nicaragua,High School diploma,1
1113,12,8,10,14,14,8,7,7,6,2,5,5,6,6,7,7,7,1,55.19399977,36,male,Argentina,High School diploma,1
1118,12,13,14,14,13,5,7,7,4,1,7,7,6,6,6,7,7,6,51.15699983,22,male,Bolivia (Estado Plurinacional de),Bachelor's degree,NA
1119,13,12,10,14,10,13,7,7,7,6,7,3,7,6,4,6,6,6,49.79299998,21,female,Argentina,High School diploma,6
1122,14,14,14,14,14,5,7,7,4,1,7,7,7,7,7,7,7,7,80.89999986,40,male,Bolivia (Estado Plurinacional de),Professional degree,7
1123,13,12,14,14,14,7,7,7,6,1,7,7,7,6,7,7,7,5,81.75900006,29,male,Venezuela (República Bolivariana de),High School diploma,7
1124,14,5,14,11,10,9,5,6,2,7,7,7,7,7,3,7,2,3,100.599,44,female,Venezuela (República Bolivariana de),High School diploma,2
1127,14,9,14,13,12,12,6,7,6,6,7,7,7,7,6,6,5,4,105.165,35,female,Argentina,High School diploma,1
1129,13,14,14,14,11,11,7,7,6,5,7,7,6,7,7,4,7,7,40.83000016,NA,NA,,,NA
1131,12,6,8,10,10,7,4,6,5,2,4,4,6,6,4,6,4,2,44.14799976,28,male,Bolivia (Estado Plurinacional de),High School diploma,7
1132,14,14,14,13,14,2,6,7,1,1,7,7,7,7,7,7,7,7,47.58999991,22,female,Argentina,Technical or vocational training,3
1134,12,13,12,14,13,10,7,7,5,5,5,7,6,6,6,7,7,6,48.82000017,51,female,Venezuela (República Bolivariana de),Bachelor's degree,1
1136,14,11,14,13,10,8,6,7,4,4,7,7,7,7,5,5,6,5,37.27999997,NA,NA,,,NA
1139,13,10,13,10,14,6,6,4,4,2,7,6,7,6,7,7,5,5,63.42700005,19,female,Argentina,High School diploma,1
1140,12,12,12,12,13,5,6,6,2,3,6,6,6,6,7,6,6,6,34.72100019,25,male,Bolivia (Estado Plurinacional de),Bachelor's degree,1
1141,14,14,14,14,14,10,7,7,6,4,7,7,7,7,7,7,7,7,56.8210001,23,male,Venezuela (República Bolivariana de),High School diploma,7
1142,14,12,14,14,14,8,7,7,4,4,7,7,7,7,7,7,6,6,57.31999993,NA,NA,,,NA
1146,13,14,14,14,14,13,7,7,6,7,7,7,7,6,7,7,7,7,47.53100014,30,female,El Salvador,High School diploma,1
1149,13,5,14,13,12,11,6,7,4,7,7,7,7,6,7,5,2,3,67.76300001,44,NA,Argentina,Professional degree,2
1151,8,6,13,14,12,11,7,7,4,7,7,6,4,4,6,6,2,4,131.9680002,37,male,Venezuela (República Bolivariana de),Technical or vocational training,NA
1155,11,11,14,14,14,13,7,7,6,7,7,7,6,5,7,7,6,5,85.73600006,19,female,Nicaragua,Technical or vocational training,5
1157,14,14,12,11,14,2,4,7,1,1,5,7,7,7,7,7,7,7,52.40900016,36,male,Argentina,,7
1161,11,13,14,14,14,4,7,7,3,1,7,7,6,5,7,7,7,6,58.89800024,19,female,Bolivia (Estado Plurinacional de),Professional degree,1
1163,11,11,14,13,11,2,6,7,1,1,7,7,7,4,4,7,4,7,79.40499997,29,male,Argentina,High School diploma,5
1164,14,14,14,14,14,2,7,7,1,1,7,7,7,7,7,7,7,7,44.70499992,38,male,Argentina,High School diploma,1
1165,9,8,14,14,14,8,7,7,4,4,7,7,5,4,7,7,4,4,56.44400001,30,male,,Technical or vocational training,4
1167,14,9,14,13,10,14,6,7,7,7,7,7,7,7,5,5,4,5,62.17299986,41,NA,Venezuela (República Bolivariana de),Professional degree,1
1168,12,10,11,11,10,2,5,6,1,1,6,5,6,6,5,5,5,5,51.53200006,68,male,Venezuela (República Bolivariana de),Bachelor's degree,3
1169,14,11,14,14,14,9,7,7,4,5,7,7,7,7,7,7,5,6,53.23699999,39,female,Venezuela (República Bolivariana de),High School diploma,4
1173,14,13,14,13,13,13,7,6,7,6,7,7,7,7,6,7,7,6,44.43700004,30,male,Nicaragua,High School diploma,NA
1179,14,14,14,14,14,12,7,7,5,7,7,7,7,7,7,7,7,7,78.06299996,26,male,Bolivia (Estado Plurinacional de),High School diploma,1
1180,11,14,14,14,14,11,7,7,4,7,7,7,7,4,7,7,7,7,58.33399987,37,male,Perú,Technical or vocational training,2
1182,11,14,10,11,13,10,6,5,4,6,6,4,7,4,7,6,7,7,56.29300022,31,male,Argentina,Associate's degree,3
1184,14,14,14,14,11,13,7,7,6,7,7,7,7,7,4,7,7,7,58.97199988,NA,NA,,,NA
1185,13,9,13,14,12,12,7,7,7,5,7,6,7,6,5,7,7,2,60.18700004,47,male,Argentina,Professional degree,7
1187,8,8,14,14,13,2,7,7,1,1,7,7,7,1,6,7,7,1,123.783,42,female,Venezuela (República Bolivariana de),Bachelor's degree,1
1188,13,12,12,14,14,6,7,7,5,1,6,6,7,6,7,7,6,6,44.74199986,38,NA,Venezuela (República Bolivariana de),Bachelor's degree,4
1189,12,10,12,13,14,8,6,7,4,4,6,6,7,5,7,7,5,5,41.88399982,24,NA,Colombia,Technical or vocational training,1
1191,14,6,14,14,9,12,7,7,7,5,7,7,7,7,7,2,3,3,60.37199974,51,female,Colombia,High School diploma,1
1192,14,12,14,13,11,5,6,7,4,1,7,7,7,7,6,5,7,5,79.82300019,20,female,Honduras,,1
1193,8,5,14,13,12,11,6,7,7,4,7,7,4,4,5,7,1,4,71.66400003,21,male,Bolivia (Estado Plurinacional de),High School diploma,7
1196,12,12,14,14,12,5,7,7,4,1,7,7,6,6,5,7,6,6,107.892,44,female,Colombia,Professional degree,1
1197,14,8,14,14,14,14,7,7,7,7,7,7,7,7,7,7,7,1,60.36899996,48,male,,High School diploma,NA
1198,14,14,12,11,11,2,7,4,1,1,5,7,7,7,7,4,7,7,67.50699997,27,male,El Salvador,High School diploma,1
1199,14,6,13,11,9,13,4,7,7,6,6,7,7,7,4,5,3,3,135.2090001,38,female,Venezuela (República Bolivariana de),Bachelor's degree,1
1200,12,10,11,12,10,8,6,6,5,3,5,6,6,6,6,4,5,5,60.48999977,79,male,Argentina,Master's degree,NA
1202,11,14,14,13,14,11,6,7,6,5,7,7,7,4,7,7,7,7,63.81800032,NA,female,Argentina,High School diploma,7
1203,13,12,14,12,11,4,5,7,2,2,7,7,7,6,4,7,6,6,63.50500011,18,female,Colombia,High School diploma,NA
1205,12,11,10,13,12,9,6,7,3,6,5,5,6,6,6,6,6,5,37.23399973,18,female,Colombia,High School diploma,3
1206,12,14,12,10,14,11,5,5,6,5,7,5,7,5,7,7,7,7,65.79999995,NA,NA,,,NA
1207,14,14,14,13,14,7,7,6,1,6,7,7,7,7,7,7,7,7,40.44200015,22,NA,Venezuela (República Bolivariana de),High School diploma,5
1208,12,14,14,14,14,14,7,7,7,7,7,7,7,5,7,7,7,7,99.08700013,29,female,Venezuela (República Bolivariana de),Bachelor's degree,1
1210,13,10,14,14,13,10,7,7,5,5,7,7,7,6,7,6,5,5,75.63999987,36,female,Venezuela (República Bolivariana de),Bachelor's degree,4
1212,11,9,14,14,14,7,7,7,4,3,7,7,7,4,7,7,5,4,54.47200012,34,female,Nicaragua,Bachelor's degree,1
1215,5,5,8,14,11,2,7,7,1,1,4,4,3,2,6,5,2,3,47.60200024,NA,NA,,,NA
1216,7,4,7,14,10,2,7,7,1,1,4,3,4,3,5,5,2,2,35.13600016,NA,NA,,,NA
1217,6,6,8,12,14,2,6,6,1,1,4,4,3,3,7,7,3,3,32.14400005,NA,NA,,,NA
1222,14,14,14,14,11,5,7,7,1,4,7,7,7,7,7,4,7,7,54.23500013,NA,NA,,,NA
1223,11,8,14,14,12,11,7,7,5,6,7,7,6,5,5,7,4,4,74.9059999,25,male,Venezuela (República Bolivariana de),Professional degree,6
1225,10,9,11,10,7,14,6,4,7,7,4,7,6,4,6,1,2,7,63.81699991,NA,NA,,,NA
1231,10,2,13,11,12,10,4,7,4,6,7,6,4,6,5,7,1,1,59.59799981,34,male,Argentina,High School diploma,4
1233,14,14,14,14,14,13,7,7,6,7,7,7,7,7,7,7,7,7,52.70900011,40,male,El Salvador,Technical or vocational training,6
1234,12,12,12,12,7,2,6,6,1,1,6,6,6,6,6,1,6,6,46.30800009,68,male,Venezuela (República Bolivariana de),Bachelor's degree,4
1236,11,9,12,12,12,9,6,6,5,4,6,6,5,6,6,6,5,4,83.81699991,26,female,Bolivia (Estado Plurinacional de),Technical or vocational training,7
1241,14,14,14,14,14,3,7,7,1,2,7,7,7,7,7,7,7,7,44.61399984,27,female,Venezuela (República Bolivariana de),Technical or vocational training,1
1243,11,12,12,13,12,7,7,6,3,4,6,6,5,6,5,7,6,6,68.22099996,22,female,Bolivia (Estado Plurinacional de),Technical or vocational training,2
1246,14,14,14,14,14,2,7,7,1,1,7,7,7,7,7,7,7,7,42.90899992,31,female,El Salvador,High School diploma,1
1247,14,2,14,14,9,14,7,7,7,7,7,7,7,7,2,7,1,1,55.71400023,31,female,Nicaragua,Bachelor's degree,2
1248,13,11,12,11,13,11,5,6,6,5,6,6,7,6,6,7,6,5,59.5079999,21,male,Ecuador,High School diploma,4
1249,13,12,14,14,13,2,7,7,1,1,7,7,7,6,6,7,6,6,110.8069999,27,female,El Salvador,Bachelor's degree,1
1250,14,13,14,14,14,5,7,7,4,1,7,7,7,7,7,7,6,7,75.07500005,32,male,Bolivia (Estado Plurinacional de),High School diploma,3
1251,13,11,13,14,6,2,7,7,1,1,7,6,7,6,4,2,5,6,90.29799986,37,female,El Salvador,Bachelor's degree,1
1252,10,11,12,11,12,4,6,5,2,2,6,6,5,5,6,6,6,5,40.31800008,NA,NA,,,NA
1255,10,6,13,9,13,11,3,6,7,4,6,7,6,4,6,7,1,5,63.79400015,32,male,Bolivia (Estado Plurinacional de),High School diploma,1
1256,13,11,8,13,9,6,6,7,5,1,1,7,6,7,4,5,7,4,92.83599997,42,female,Bolivia (Estado Plurinacional de),High School diploma,1
1257,14,12,14,13,10,9,6,7,5,4,7,7,7,7,6,4,6,6,58.09200001,51,female,Venezuela (República Bolivariana de),Technical or vocational training,1
1263,12,12,12,12,12,8,6,6,5,3,6,6,6,6,6,6,6,6,89.51899981,26,female,Bolivia (Estado Plurinacional de),Bachelor's degree,3
1269,14,10,14,14,6,2,7,7,1,1,7,7,7,7,1,5,5,5,56.59500027,27,male,Nicaragua,Bachelor's degree,1
1270,13,8,13,12,12,3,6,6,2,1,6,7,7,6,7,5,4,4,70.05299997,38,NA,Venezuela (República Bolivariana de),Bachelor's degree,1
1273,14,11,13,14,11,7,7,7,5,2,7,6,7,7,5,6,6,5,117.0839999,19,male,Venezuela (República Bolivariana de),High School diploma,6
1274,14,11,14,14,7,12,7,7,5,7,7,7,7,7,3,4,4,7,48.01499987,30,male,Venezuela (República Bolivariana de),High School diploma,2
1275,12,8,14,14,13,11,7,7,7,4,7,7,6,6,6,7,4,4,45.5079999,41,female,Guatemala,Technical or vocational training,1
1280,14,10,14,14,14,5,7,7,4,1,7,7,7,7,7,7,6,4,57.61100006,31,female,Venezuela (República Bolivariana de),Bachelor's degree,7
1281,13,12,13,14,3,12,7,7,6,6,6,7,7,6,1,2,6,6,85.92599988,46,female,Venezuela (República Bolivariana de),Professional degree,1
1282,12,12,11,12,12,6,5,7,5,1,6,5,6,6,6,6,6,6,91.2980001,NA,NA,,,NA
1283,14,14,14,13,14,8,6,7,3,5,7,7,7,7,7,7,7,7,52.23799992,NA,NA,,,NA
1284,14,12,12,11,12,9,4,7,4,5,6,6,7,7,6,6,6,6,55.36000013,47,female,Venezuela (República Bolivariana de),Master's degree,4
1285,8,14,14,14,11,9,7,7,5,4,7,7,4,4,4,7,7,7,105.6039999,22,female,Venezuela (República Bolivariana de),Bachelor's degree,1
1288,7,14,14,14,8,8,7,7,4,4,7,7,4,3,4,4,7,7,76.18400002,24,male,Bolivia (Estado Plurinacional de),Bachelor's degree,1
1290,14,14,14,14,14,11,7,7,7,4,7,7,7,7,7,7,7,7,88.03500009,39,female,Venezuela (República Bolivariana de),High School diploma,1
1291,14,14,14,14,14,2,7,7,1,1,7,7,7,7,7,7,7,7,43.13399982,NA,NA,,,NA
1292,13,14,14,12,14,2,6,6,1,1,7,7,7,6,7,7,7,7,87.56700015,20,male,Venezuela (República Bolivariana de),High School diploma,2
1295,14,14,14,10,9,10,3,7,5,5,7,7,7,7,6,3,7,7,30.38300014,19,female,Colombia,High School diploma,1
1296,8,9,10,8,10,8,5,3,3,5,5,5,5,3,6,4,3,6,41.40300012,18,male,Ecuador,High School diploma,7
1297,14,14,14,13,14,9,7,6,7,2,7,7,7,7,7,7,7,7,106.9489999,60,female,Venezuela (República Bolivariana de),Bachelor's degree,1
1298,13,10,11,13,13,2,6,7,1,1,5,6,7,6,7,6,5,5,73.38000011,NA,NA,,,NA
1299,6,8,14,14,11,10,7,7,4,6,7,7,5,1,4,7,4,4,58.31700015,20,male,Venezuela (República Bolivariana de),High School diploma,1
1306,14,11,14,14,6,6,7,7,1,5,7,7,7,7,4,2,6,5,88.34800005,35,female,Nicaragua,High School diploma,3
1308,13,13,14,14,14,10,7,7,5,5,7,7,7,6,7,7,6,7,119.0239997,23,female,Venezuela (República Bolivariana de),High School diploma,5
1311,8,5,9,14,14,14,7,7,7,7,4,5,4,4,7,7,4,1,98.35500002,23,female,Venezuela (República Bolivariana de),High School diploma,1
1314,12,12,12,14,12,2,7,7,1,1,6,6,7,5,6,6,6,6,107.6199999,34,female,Venezuela (República Bolivariana de),Professional degree,1
1315,14,13,14,14,14,8,7,7,4,4,7,7,7,7,7,7,7,6,72.44499993,30,male,Colombia,Technical or vocational training,1
1316,14,4,14,14,14,7,7,7,1,6,7,7,7,7,7,7,2,2,81.65799999,27,male,Bolivia (Estado Plurinacional de),Professional degree,1
1317,14,11,14,11,10,8,4,7,3,5,7,7,7,7,4,6,5,6,44.31299996,23,female,Venezuela (República Bolivariana de),High School diploma,NA
1318,12,10,12,12,10,10,5,7,7,3,5,7,7,5,5,5,5,5,95.74900007,19,female,El Salvador,High School diploma,2
1319,12,12,12,11,13,8,5,6,3,5,7,5,5,7,6,7,6,6,39.82700014,19,female,Nicaragua,High School diploma,NA
1320,12,10,11,11,9,7,5,6,4,3,6,5,6,6,4,5,5,5,59.05000019,NA,NA,,,NA
1322,14,14,13,13,13,11,7,6,7,4,7,6,7,7,6,7,7,7,72.62400007,70,male,Venezuela (República Bolivariana de),Associate's degree,4
1324,14,14,14,14,13,8,7,7,4,4,7,7,7,7,6,7,7,7,47.77999973,28,male,Argentina,High School diploma,3
1325,5,11,10,13,14,10,7,6,6,4,5,5,2,3,7,7,6,5,49.97900009,28,NA,El Salvador,Bachelor's degree,NA
1326,14,13,14,10,11,9,4,6,5,4,7,7,7,7,6,5,7,6,65.36500001,NA,NA,,,NA
1327,14,14,14,14,14,11,7,7,4,7,7,7,7,7,7,7,7,7,49.5710001,35,female,Venezuela (República Bolivariana de),High School diploma,4
1328,14,14,10,12,11,8,6,6,5,3,5,5,7,7,6,5,7,7,73.37800002,81,female,,,NA
1331,14,13,11,10,14,2,3,7,1,1,6,5,7,7,7,7,7,6,111.4259999,57,male,República Dominicana,Bachelor's degree,7
1332,7,7,14,14,11,14,7,7,7,7,7,7,3,4,5,6,4,3,46.84899998,37,male,Colombia,Technical or vocational training,1
1335,14,14,14,14,14,6,7,7,3,3,7,7,7,7,7,7,7,7,75.40899992,28,female,Venezuela (República Bolivariana de),Professional degree,1
1336,11,5,12,12,10,9,6,6,5,4,6,6,5,6,4,6,2,3,55.18000007,29,NA,,,NA
1337,13,8,14,14,12,14,7,7,7,7,7,7,6,7,5,7,4,4,43.11999989,NA,male,Nicaragua,Technical or vocational training,5
1338,12,12,12,13,10,6,6,7,1,5,6,6,6,6,4,6,6,6,74.704,33,male,Honduras,Bachelor's degree,1
1341,8,8,12,10,8,6,6,4,4,2,6,6,4,4,4,4,6,2,69.81399989,22,NA,Bolivia (Estado Plurinacional de),Associate's degree,2
1343,11,13,14,13,14,3,6,7,1,2,7,7,6,5,7,7,6,7,55.15200019,32,female,Venezuela (República Bolivariana de),Bachelor's degree,4
1345,12,6,14,11,14,9,4,7,5,4,7,7,6,6,7,7,2,4,58.51299977,22,female,Venezuela (República Bolivariana de),High School diploma,2
1346,12,13,14,12,12,9,6,6,2,7,7,7,6,6,6,6,7,6,109.9840002,NA,female,,,NA
1349,14,14,13,14,14,7,7,7,6,1,6,7,7,7,7,7,7,7,56.01999998,25,NA,Venezuela (República Bolivariana de),High School diploma,1
1350,13,14,14,13,14,2,6,7,1,1,7,7,7,6,7,7,7,7,69.18700004,30,NA,Venezuela (República Bolivariana de),Bachelor's degree,1
1354,10,9,14,12,12,5,5,7,3,2,7,7,5,5,6,6,4,5,74.3809998,35,female,Venezuela (República Bolivariana de),Technical or vocational training,2
1355,11,8,14,14,14,8,7,7,4,4,7,7,7,4,7,7,4,4,91.88100004,28,male,Argentina,High School diploma,7
1356,12,12,14,14,10,6,7,7,2,4,7,7,7,5,5,5,6,6,62.95700026,18,male,Ecuador,High School diploma,2
1358,9,9,14,11,9,11,6,5,4,7,7,7,7,2,4,5,5,4,73.87199974,24,female,Venezuela (República Bolivariana de),High School diploma,1
1359,14,14,14,14,14,5,7,7,4,1,7,7,7,7,7,7,7,7,33.78399992,31,female,Bolivia (Estado Plurinacional de),Bachelor's degree,1
1360,14,14,14,14,14,4,7,7,2,2,7,7,7,7,7,7,7,7,73.18899989,35,NA,Venezuela (República Bolivariana de),High School diploma,3
1364,14,13,14,14,12,7,7,7,3,4,7,7,7,7,5,7,6,7,105.5840001,33,female,Venezuela (República Bolivariana de),Bachelor's degree,1
1369,14,14,14,14,14,11,7,7,4,7,7,7,7,7,7,7,7,7,41.25399995,30,female,Ecuador,High School diploma,1
1370,14,8,11,11,14,10,4,7,3,7,7,4,7,7,7,7,4,4,49.61800003,36,female,Venezuela (República Bolivariana de),,1
1371,14,14,13,12,14,6,6,6,3,3,7,6,7,7,7,7,7,7,47.57700014,27,female,El Salvador,High School diploma,1
1372,14,8,14,12,9,5,6,6,2,3,7,7,7,7,5,4,5,3,72.81299996,30,female,Colombia,High School diploma,2
1373,12,11,14,13,11,4,6,7,2,2,7,7,6,6,5,6,6,5,111.8410001,NA,NA,,,NA
1374,14,12,14,12,10,4,5,7,1,3,7,7,7,7,3,7,5,7,64.24900007,NA,NA,,,NA
1376,10,11,13,8,11,12,3,5,6,6,6,7,6,4,7,4,7,4,57.1880002,43,female,Venezuela (República Bolivariana de),High School diploma,2
1377,14,10,14,13,13,7,7,6,5,2,7,7,7,7,6,7,6,4,58.41299987,40,male,Bolivia (Estado Plurinacional de),Bachelor's degree,7
1380,13,12,14,14,12,13,7,7,7,6,7,7,7,6,5,7,5,7,62.5710001,40,female,Honduras,High School diploma,NA
1383,14,8,14,14,9,6,7,7,5,1,7,7,7,7,7,2,7,1,87.74000001,NA,NA,,,NA
1386,13,13,14,13,13,7,6,7,3,4,7,7,7,6,7,6,6,7,64.30000019,23,male,Venezuela (República Bolivariana de),High School diploma,3
1387,12,11,12,12,11,6,6,6,3,3,6,6,6,6,6,5,5,6,50.28500009,34,female,Venezuela (República Bolivariana de),Professional degree,1
1389,14,14,14,14,14,5,7,7,4,1,7,7,7,7,7,7,7,7,91.22099996,48,female,Venezuela (República Bolivariana de),Bachelor's degree,4
1391,14,12,14,13,12,9,7,6,5,4,7,7,7,7,6,6,6,6,102.016,32,NA,Venezuela (República Bolivariana de),High School diploma,3
1392,8,13,14,14,14,7,7,7,3,4,7,7,4,4,7,7,6,7,110.289,34,female,Venezuela (República Bolivariana de),Bachelor's degree,1
1398,13,14,14,13,12,5,6,7,4,1,7,7,6,7,5,7,7,7,66.51800013,40,male,Ecuador,Technical or vocational training,2
1399,14,14,14,14,14,2,7,7,1,1,7,7,7,7,7,7,7,7,60.72899985,51,female,Venezuela (República Bolivariana de),Professional degree,3
1400,4,8,11,14,14,8,7,7,4,4,7,4,2,2,7,7,4,4,48.32099986,34,female,Venezuela (República Bolivariana de),Bachelor's degree,1
1403,14,14,14,14,13,5,7,7,2,3,7,7,7,7,6,7,7,7,74.10800004,33,male,Venezuela (República Bolivariana de),Technical or vocational training,3
1404,12,12,14,10,12,8,4,6,4,4,7,7,7,5,6,6,5,7,119.402,22,male,Bolivia (Estado Plurinacional de),High School diploma,7
1405,11,8,13,14,10,9,7,7,4,5,6,7,6,5,5,5,3,5,68.16900015,49,male,Perú,Technical or vocational training,1
1407,14,14,14,13,14,2,6,7,1,1,7,7,7,7,7,7,7,7,53.55900002,30,female,Venezuela (República Bolivariana de),High School diploma,3
1409,14,14,14,14,14,12,7,7,7,5,7,7,7,7,7,7,7,7,35.11800003,27,male,Venezuela (República Bolivariana de),High School diploma,2
1410,12,14,14,14,14,12,7,7,6,6,7,7,6,6,7,7,7,7,80.64299989,85,female,Colombia,Professional degree,NA
1413,14,13,13,14,14,2,7,7,1,1,7,6,7,7,7,7,7,6,82.55900002,32,NA,Venezuela (República Bolivariana de),Technical or vocational training,3
1414,14,13,14,14,12,3,7,7,2,1,7,7,7,7,6,6,6,7,74.648,NA,NA,,,NA
1418,6,6,4,6,6,2,1,5,1,1,3,1,1,5,3,3,1,5,100.168,30,NA,México,High School diploma,4
1424,8,14,14,14,14,14,7,7,7,7,7,7,1,7,7,7,7,7,51.82300019,NA,male,Argelia,Technical or vocational training,NA
1426,14,12,12,11,12,11,5,6,5,6,6,6,7,7,6,6,6,6,91.18400002,43,NA,Argentina,Professional degree,1
1428,14,2,14,14,14,2,7,7,1,1,7,7,7,7,7,7,1,1,40.97900009,36,female,Nicaragua,Bachelor's degree,2
1429,11,11,11,11,11,7,7,4,4,3,4,7,7,4,7,4,7,4,32.43499994,32,NA,Venezuela (República Bolivariana de),Bachelor's degree,2
1431,14,14,14,14,14,10,7,7,3,7,7,7,7,7,7,7,7,7,68.42000008,30,female,Colombia,High School diploma,1
1432,14,12,11,10,10,6,3,7,4,2,4,7,7,7,7,3,6,6,77.32399988,28,female,,,NA
1434,14,11,12,12,12,10,6,6,6,4,6,6,7,7,6,6,5,6,53.95599985,24,female,Colombia,High School diploma,NA
1435,14,12,14,14,14,13,7,7,6,7,7,7,7,7,7,7,6,6,83.0630002,27,female,Bolivia (Estado Plurinacional de),High School diploma,3
1438,8,6,9,14,14,12,7,7,5,7,5,4,4,4,7,7,2,4,50.60000014,47,female,Argentina,High School diploma,2
1440,12,13,14,14,14,12,7,7,6,6,7,7,6,6,7,7,7,6,84.49899983,34,female,Venezuela (República Bolivariana de),Bachelor's degree,1
1441,14,14,14,14,14,2,7,7,1,1,7,7,7,7,7,7,7,7,118.0330002,36,NA,Venezuela (República Bolivariana de),Bachelor's degree,1
1449,13,12,11,14,11,7,7,7,5,2,5,6,7,6,5,6,6,6,96.59100008,46,NA,Venezuela (República Bolivariana de),Technical or vocational training,3
1450,13,10,14,14,10,4,7,7,2,2,7,7,7,6,5,5,5,5,87.27699995,45,female,Venezuela (República Bolivariana de),Technical or vocational training,NA
1451,14,13,14,14,13,11,7,7,4,7,7,7,7,7,6,7,6,7,55.51399994,40,female,Venezuela (República Bolivariana de),High School diploma,1
1458,13,11,14,12,12,12,6,6,6,6,7,7,7,6,6,6,5,6,52.91699982,48,female,Bolivia (Estado Plurinacional de),Bachelor's degree,1
1460,14,12,14,14,14,14,7,7,7,7,7,7,7,7,7,7,7,5,74.13499999,53,female,Venezuela (República Bolivariana de),High School diploma,1
1462,12,8,14,14,10,10,7,7,5,5,7,7,6,6,4,6,1,7,60.68899989,41,female,Venezuela (República Bolivariana de),Bachelor's degree,1
1463,13,12,14,14,14,12,7,7,7,5,7,7,7,6,7,7,6,6,37.24099994,34,male,Argentina,High School diploma,NA
1464,9,9,14,11,13,8,5,6,6,2,7,7,4,5,7,6,4,5,84.35900021,21,female,Venezuela (República Bolivariana de),High School diploma,4
1466,12,12,14,13,12,8,6,7,6,2,7,7,6,6,6,6,6,6,81.87800002,58,NA,,Professional degree,2
1469,14,11,14,11,14,11,4,7,7,4,7,7,7,7,7,7,4,7,60.08900023,19,female,Honduras,High School diploma,NA
1470,13,5,14,11,8,9,4,7,5,4,7,7,6,7,4,4,1,4,52.78200006,74,male,Argentina,Technical or vocational training,3
1471,14,10,14,13,14,10,7,6,3,7,7,7,7,7,7,7,4,6,75.38199997,50,male,Argentina,Technical or vocational training,3
1473,12,11,13,14,14,11,7,7,5,6,7,6,6,6,7,7,6,5,61.54900002,32,male,El Salvador,High School diploma,NA
1474,14,9,14,9,13,9,3,6,2,7,7,7,7,7,6,7,5,4,95.01999998,NA,NA,,,NA
1476,12,14,14,14,14,2,7,7,1,1,7,7,6,6,7,7,7,7,33.01400018,24,NA,Venezuela (República Bolivariana de),Technical or vocational training,1
1477,11,13,9,12,13,8,6,6,4,4,4,5,6,5,6,7,7,6,55.65300012,40,female,Bolivia (Estado Plurinacional de),Bachelor's degree,3
1478,14,14,12,13,13,3,6,7,1,2,5,7,7,7,6,7,7,7,45.4749999,33,male,Honduras,High School diploma,1
1482,11,14,8,11,14,8,7,4,4,4,4,4,7,4,7,7,7,7,101.4190001,41,male,Venezuela (República Bolivariana de),High School diploma,4
1487,12,14,12,14,7,2,7,7,1,1,6,6,6,6,6,1,7,7,110.49,68,male,Venezuela (República Bolivariana de),Bachelor's degree,1
1488,14,14,14,14,14,2,7,7,1,1,7,7,7,7,7,7,7,7,82.17799997,39,NA,Perú,High School diploma,1
1489,10,6,14,11,12,4,5,6,2,2,7,7,5,5,6,6,5,1,39.99099994,NA,NA,,,NA
1490,12,8,14,10,11,10,4,6,6,4,7,7,7,5,7,4,4,4,108.1170001,47,female,Venezuela (República Bolivariana de),High School diploma,4
1492,10,10,13,13,11,9,6,7,5,4,7,6,6,4,5,6,4,6,67.19799995,34,male,Argentina,Associate's degree,1
1496,11,8,13,12,13,8,6,6,5,3,7,6,5,6,6,7,5,3,60.90999985,40,NA,Bolivia (Estado Plurinacional de),High School diploma,2
1498,12,12,12,13,14,11,6,7,6,5,6,6,6,6,7,7,6,6,62.16000009,35,NA,Venezuela (República Bolivariana de),Bachelor's degree,3
1499,14,12,14,13,14,12,7,6,7,5,7,7,7,7,7,7,7,5,66.31400013,26,female,Venezuela (República Bolivariana de),Bachelor's degree,6
1500,14,12,14,14,10,12,7,7,7,5,7,7,7,7,5,5,6,6,47.09099984,27,female,Nicaragua,Bachelor's degree,2
1507,11,7,14,11,13,13,5,6,7,6,7,7,6,5,7,6,5,2,69.75600004,44,male,Bolivia (Estado Plurinacional de),Bachelor's degree,1
1522,13,9,14,13,12,8,6,7,5,3,7,7,7,6,5,7,4,5,61.45600009,NA,NA,,,NA
1533,13,14,14,14,14,11,7,7,6,5,7,7,6,7,7,7,7,7,63.78000021,NA,NA,,,NA
1535,14,14,14,14,14,2,7,7,1,1,7,7,7,7,7,7,7,7,65.59300017,34,NA,Colombia,High School diploma,2
1536,14,14,14,14,14,6,7,7,1,5,7,7,7,7,7,7,7,7,62.01699996,43,female,Venezuela (República Bolivariana de),Bachelor's degree,2
1539,13,14,14,13,12,10,7,6,5,5,7,7,7,6,5,7,7,7,70.01399994,39,female,Venezuela (República Bolivariana de),Bachelor's degree,1
1540,12,5,11,13,12,2,6,7,1,1,5,6,6,6,6,6,3,2,68.13999987,NA,NA,,,NA
1543,14,14,12,14,14,2,7,7,1,1,7,5,7,7,7,7,7,7,32.13500023,18,female,Colombia,High School diploma,NA
1544,14,14,14,14,6,7,7,7,4,3,7,7,7,7,5,1,7,7,103.9430001,36,NA,Venezuela (República Bolivariana de),,1
1545,14,12,14,14,14,13,7,7,6,7,7,7,7,7,7,7,6,6,57.23300028,29,NA,Venezuela (República Bolivariana de),Professional degree,1
1547,13,14,11,14,14,13,7,7,6,7,7,4,7,6,7,7,7,7,44.898,33,male,Colombia,Technical or vocational training,1
1549,13,14,14,12,14,8,6,6,5,3,7,7,7,6,7,7,7,7,39.17800021,NA,female,México,High School diploma,3
1554,6,8,12,14,12,6,7,7,2,4,6,6,4,2,5,7,5,3,64.92399979,25,NA,Nicaragua,Professional degree,5
1555,14,14,14,14,13,9,7,7,4,5,7,7,7,7,6,7,7,7,79.70899987,36,NA,México,Bachelor's degree,3
1557,11,11,12,11,10,5,6,5,3,2,6,6,5,6,5,5,6,5,95.9849999,27,female,El Salvador,High School diploma,2
1565,14,13,12,14,10,6,7,7,3,3,6,6,7,7,7,3,7,6,71.06800008,30,female,Bolivia (Estado Plurinacional de),Technical or vocational training,1
1567,13,13,13,11,12,5,4,7,3,2,7,6,6,7,5,7,6,7,48.7980001,55,NA,,,NA
1568,14,14,14,14,14,10,7,7,5,5,7,7,7,7,7,7,7,7,70.50999999,60,NA,Venezuela (República Bolivariana de),Master's degree,7
1569,13,8,14,14,14,11,7,7,5,6,7,7,6,7,7,7,5,3,51.66699982,NA,NA,,,NA
1571,13,10,14,14,10,11,7,7,5,6,7,7,7,6,6,4,5,5,58.97699976,36,female,Colombia,Technical or vocational training,1
1577,13,13,14,14,14,13,7,7,6,7,7,7,6,7,7,7,7,6,41.08700013,54,female,Argentina,High School diploma,2
1581,12,11,14,14,11,12,7,7,7,5,7,7,7,5,4,7,6,5,63.70800018,45,female,Venezuela (República Bolivariana de),Professional degree,1
1587,14,14,14,14,14,2,7,7,1,1,7,7,7,7,7,7,7,7,54.31800008,27,female,Venezuela (República Bolivariana de),High School diploma,1
1589,14,14,12,13,13,6,7,6,5,1,6,6,7,7,6,7,7,7,86.38899994,37,female,,Professional degree,1
1593,13,10,12,14,12,13,7,7,6,7,7,5,6,7,6,6,5,5,53.62600017,20,male,Nicaragua,High School diploma,5
1598,8,14,14,14,14,14,7,7,7,7,7,7,7,1,7,7,7,7,61.76999998,36,male,Colombia,Professional degree,1
1600,14,14,11,10,14,10,4,6,4,6,6,5,7,7,7,7,7,7,59.1730001,52,NA,Venezuela (República Bolivariana de),Bachelor's degree,NA
1602,14,14,14,11,14,9,4,7,3,6,7,7,7,7,7,7,7,7,51.58599997,29,female,Honduras,High School diploma,5
1603,13,14,14,11,13,12,4,7,7,5,7,7,7,6,6,7,7,7,82.21099997,34,NA,Bolivia (Estado Plurinacional de),Technical or vocational training,1
1604,14,11,14,14,13,13,7,7,6,7,7,7,7,7,6,7,5,6,39.43400002,26,male,Guatemala,Master's degree,3
1605,14,14,14,14,13,14,7,7,7,7,7,7,7,7,6,7,7,7,37.55200005,26,male,Guatemala,Master's degree,3
1606,13,11,12,13,14,9,6,7,5,4,6,6,7,6,7,7,5,6,58.61800003,29,male,El Salvador,High School diploma,3
1608,14,14,13,13,12,9,6,7,5,4,6,7,7,7,7,5,7,7,40.2249999,NA,NA,,,NA
1609,13,9,12,13,12,7,6,7,3,4,6,6,7,6,6,6,4,5,52.14899993,27,female,Guatemala,Bachelor's degree,1
1615,14,13,12,13,8,11,6,7,6,5,6,6,7,7,2,6,6,7,63.98500013,64,male,Venezuela (República Bolivariana de),Professional degree,NA
1616,14,14,14,12,11,7,5,7,3,4,7,7,7,7,4,7,7,7,51.56999993,54,female,Honduras,Bachelor's degree,1
1617,12,11,12,11,13,10,6,5,4,6,6,6,6,6,6,7,6,5,53.85899997,54,male,Paraguay,High School diploma,1
1622,5,4,6,4,6,6,2,2,4,2,4,2,1,4,2,4,2,2,124.2449999,NA,female,Venezuela (República Bolivariana de),Bachelor's degree,4
1623,14,12,14,14,14,9,7,7,7,2,7,7,7,7,7,7,6,6,84.79500008,29,female,Paraguay,Professional degree,1
1624,14,14,14,14,12,10,7,7,3,7,7,7,7,7,6,6,7,7,84.78100014,44,female,Venezuela (República Bolivariana de),Bachelor's degree,1
1626,12,11,12,12,12,9,5,7,6,3,6,6,6,6,6,6,6,5,66.84399986,48,NA,,High School diploma,1
1629,13,12,14,14,13,2,7,7,1,1,7,7,7,6,6,7,6,6,61.88300014,30,male,Venezuela (República Bolivariana de),,1
1637,14,14,14,14,14,13,7,7,6,7,7,7,7,7,7,7,7,7,39.07700014,NA,NA,,,NA
1638,12,9,12,12,10,2,7,5,1,1,5,7,6,6,4,6,4,5,58.81999993,24,female,Bolivia (Estado Plurinacional de),Bachelor's degree,6
1641,10,9,11,8,7,5,5,3,2,3,6,5,5,5,3,4,5,4,39.40300012,55,female,Venezuela (República Bolivariana de),Bachelor's degree,1
1642,14,14,13,13,14,5,6,7,3,2,7,6,7,7,7,7,7,7,111.638,33,NA,Venezuela (República Bolivariana de),Professional degree,2
1644,9,12,12,11,12,9,5,6,5,4,7,5,5,4,6,6,6,6,51.66800022,29,male,Bolivia (Estado Plurinacional de),Bachelor's degree,3
1646,14,13,14,13,13,11,7,6,5,6,7,7,7,7,6,7,7,6,101.3730001,NA,NA,,,NA
1648,12,10,10,11,9,9,5,6,5,4,5,5,6,6,4,5,5,5,80.69099998,23,male,Bolivia (Estado Plurinacional de),Technical or vocational training,4
1650,14,14,14,14,14,2,7,7,1,1,7,7,7,7,7,7,7,7,53.0999999,NA,NA,,,NA
1651,14,14,14,14,14,9,7,7,4,5,7,7,7,7,7,7,7,7,42.19299984,38,male,,Professional degree,3
1655,14,11,14,13,13,14,6,7,7,7,7,7,7,7,7,6,5,6,72.34100008,54,NA,Venezuela (República Bolivariana de),Bachelor's degree,3
1656,12,8,14,14,13,9,7,7,7,2,7,7,7,5,7,6,4,4,64.98199987,40,female,Nicaragua,,NA
1659,14,13,14,14,14,7,7,7,6,1,7,7,7,7,7,7,6,7,67.28799987,42,female,Bolivia (Estado Plurinacional de),Bachelor's degree,3
1660,10,12,13,9,13,4,4,5,2,2,7,6,5,5,7,6,6,6,139.6329999,21,male,Venezuela (República Bolivariana de),Technical or vocational training,5
1661,13,10,14,13,13,10,6,7,6,4,7,7,7,6,7,6,5,5,77.37299991,49,male,Venezuela (República Bolivariana de),High School diploma,7
1662,14,10,14,14,14,14,7,7,7,7,7,7,7,7,7,7,7,3,74.3360002,31,female,Nicaragua,High School diploma,1
1665,14,14,14,14,14,8,7,7,4,4,7,7,7,7,7,7,7,7,61.57599998,37,female,Venezuela (República Bolivariana de),Professional degree,3
1666,14,8,13,13,10,8,7,6,2,6,6,7,7,7,5,5,5,3,134.2980001,45,female,Venezuela (República Bolivariana de),High School diploma,1
1674,14,14,14,14,2,6,7,7,5,1,7,7,7,7,1,1,7,7,80.38100004,42,male,Ecuador,Professional degree,NA
1675,14,14,12,14,10,5,7,7,4,1,5,7,7,7,5,5,7,7,107.325,50,female,,,1
1676,14,11,14,12,12,7,7,5,6,1,7,7,7,7,6,6,5,6,58.53800011,38,female,Venezuela (República Bolivariana de),Bachelor's degree,7
